=================================================================================
This file can be created from Audiveris GUI

Go to advanced options and click "Dump all Units". 
Copy the lines generated in the log to this file, to update for future versions
==================================================================================

UnitManager. All Units:

[org.audiveris.omr.Main]
locale                          String                =      en                       	Locale language to be used in the whole application (en, fr)
persistBatchCliConstants       Boolean                =      false                    	Should we persist CLI-defined constants when running in batch?
processSystemsInParallel       Boolean                =      false                    	Should we process all systems in parallel in a sheet?
runBatchTasksInParallel        Boolean                =      false                    	Should we process all tasks in parallel when running in batch?
sheetStepTimeOut               Integer (Seconds)      =      120                      	Time-out for one step on a sheet, specified in seconds
showEnvironment                Boolean                =      true                     	Should we show environment?
supportedLocales                String                =      en,fr                    	Comma-separated list of supported locale languages

[org.audiveris.omr.classifier.AbstractClassifier]
minWeight                 AreaFraction (Interline**2) =      0.04                     	Minimum normalized weight to be considered not a noise
printWatch                     Boolean                =      false                    	Should we print out the stop watch?

[org.audiveris.omr.classifier.BasicClassifier]
amplitude                        Ratio                =      0.5                      	Initial weight amplitude
learningRate                     Ratio                =      0.1                      	Learning Rate
maxEpochs                      Integer (Epochs)       =      500                      	Maximum number of epochs in training
momentum                         Ratio                =      0.2                      	Training momentum
printWatch                     Boolean                =      false                    	Should we print out the stop watch?

[org.audiveris.omr.classifier.SampleRepository]
printSampleCounts              Boolean                =      false                    	Should we print out the count of samples per shape?
printWatch                     Boolean                =      false                    	Should we print out the stop watch?
useTribes                      Boolean                =      false                    	Should we support tribes?

[org.audiveris.omr.classifier.ShapeClassifier]

[org.audiveris.omr.classifier.ui.SampleBoard]
shapeIconHeight             PixelCount (Pixels)       =      70                       	Exact pixel height for the shape icon field
shapeIconWidth              PixelCount (Pixels)       =      50                       	Exact pixel width for the shape icon field

[org.audiveris.omr.classifier.ui.SelectionPanel]
maxShapeSampleCount            Integer (samples)      =      150                      	Maximum sample count per shape for training
minShapeSampleCount            Integer (samples)      =      10                       	Minimum sample count per shape for training

[org.audiveris.omr.classifier.ui.TrainingPanel]
listenerPeriod                 Integer (period)       =      50                       	Period (in iterations) between listener calls

[org.audiveris.omr.glyph.GlyphIndex]
vipGlyphs                       String                =                               	(Debug) Comma-separated values of VIP glyphs IDs

[org.audiveris.omr.glyph.Grades]
clefMinGrade                     Grade (Grade)        =      0.03                     	Minimum grade for a clef
goodBarConnectorGrade            Ratio                =      0.65                     	Good interpretation grade for a bar connector
goodBeamGrade                    Ratio                =      0.35                     	Minimum grade for being a good beam
goodInterGrade                   Ratio                =      0.5                      	Default good interpretation grade
goodRelationGrade                Ratio                =      0.5                      	Default good relation grade
intrinsicRatio                   Ratio                =      0.8                      	Reduction ratio applied on any intrinsic grade
keyAlterMinGrade1                Grade (Grade)        =      0.1                      	Minimum grade for a key item symbol, phase 1 (component)
keyAlterMinGrade2                Grade (Grade)        =      0.01                     	Minimum grade for a key item symbol, phase 2 (staff slice)
keySigMinGrade                   Grade (Grade)        =      0.01                     	Minimum grade for a key signature
minContextualGrade               Ratio                =      0.5                      	Default minimum interpretation contextual grade
minInterGrade                    Ratio                =      0.1                      	Default minimum interpretation grade
ratherGoodHeadGrade              Ratio                =      0.3                      	Rather good interpretation grade for a head
symbolMinGrade                   Grade (Grade)        =      0.15                     	Minimum grade for a symbol
timeMinGrade                     Grade (Grade)        =      0.1                      	Minimum grade for a time sig
validationMinGrade               Grade (Grade)        =      0.8                      	Minimum grade for a validation

[org.audiveris.omr.glyph.ShapeChecker]
applySpecificCheck             Boolean                =      true                     	Should we apply specific checks on shape candidates?
maxGapToStaff                 Fraction (Interline)    =      8.0                      	Maximum vertical gap between a note-like glyph and closest staff
maxLyricsHeight               Fraction (Interline)    =      2.5                      	Maximum normalized height for a lyrics text
maxMeasureRepeatPitchPosition       Double (PitchPosition) =      1.0                      	Maximum absolute pitch position for a measure repeat sign
maxMediumDynamicsHeight       Fraction (Interline)    =      2.0                      	Maximum height for small dynamics (with p, no f)
maxSmallDynamicsHeight        Fraction (Interline)    =      1.5                      	Maximum height for small dynamics (no p, no f)
maxTallDynamicsHeight         Fraction (Interline)    =      2.5                      	Maximum height for tall dynamics (with f)
maxTimePitchPositionMargin       Double (PitchPosition) =      1.0                      	Maximum absolute pitch position margin for a time signature
maxTitleHeight                Fraction (Interline)    =      4.0                      	Maximum normalized height for a title text
maxTupletPitchPosition          Double (PitchPosition) =      17.0                     	Maximum absolute pitch position for a tuplet
measureRestDx                 Fraction (Interline)    =      0.2                      	Minimum horizontal margin around a measure-rest candidate
minDirectionPitchPosition       Double (PitchPosition) =      -13.0                    	Minimum pitch value for a  segno / coda direction
minTitlePitchPosition           Double (PitchPosition) =      15.0                     	Minimum absolute pitch position for a title

[org.audiveris.omr.glyph.ShapeSet]
addClutterInPhysicals          Boolean                =      false                    	(Hidden feature)

[org.audiveris.omr.glyph.dynamic.Filament]
probeWidth                    Fraction (Interline)    =      0.5                      	Width of probing window to retrieve filament ordinate

[org.audiveris.omr.glyph.dynamic.FilamentFactory]
maxConsistentRatio               Ratio                =      1.7                      	Maximum thickness ratio for consistent merge
maxCoordGap                   Fraction (Interline)    =      1.0                      	Maximum delta coordinate for a gap between filaments
maxDeltaSlope                    Ratio                =      0.01                     	Maximum slope difference between long filaments
maxExpansionSpace             Fraction (Interline)    =      0.02                     	Maximum space when expanding filaments
maxFilamentThickness      LineFraction (Line)         =      1.5                      	Maximum filament thickness WRT mean line height
maxGapSlope                     Double (tangent)      =      0.5                      	Maximum absolute slope for a gap
maxInvolvingLength            Fraction (Interline)    =      2.0                      	Maximum filament length to apply thickness test
maxOverlapDeltaPos            Fraction (Interline)    =      0.5                      	Maximum delta position between two overlapping filaments
maxOverlapSpace               Fraction (Interline)    =      0.16                     	Maximum space between overlapping filaments
maxPosGap                 LineFraction (Line)         =      0.75                     	Maximum delta position for a gap between filaments
maxPosGapForSlope             Fraction (Interline)    =      0.1                      	Maximum delta Y to check slope for a gap between filaments
minCoreSectionLength          Fraction (Interline)    =      0.9                      	Minimum length for a section to be considered as core
minLengthForDeltaSlope        Fraction (Interline)    =      10.0                     	Minimum filament length to apply delta slope test
minSectionAspect                 Ratio                =      3.0                      	Minimum section aspect (length / thickness)
printParameters                Boolean                =      false                    	Should we print out the factory parameters?
printWatch                     Boolean                =      false                    	Should we print out the stop watch?

[org.audiveris.omr.glyph.dynamic.FilamentIndex]
vipFilaments                    String                =                               	(Debug) Comma-separated values of VIP filaments IDs

[org.audiveris.omr.glyph.dynamic.StickFactory]
printWatch                     Boolean                =      false                    	Should we print out the stop watch for StickFactory?

[org.audiveris.omr.glyph.ui.EvaluationBoard]
minGrade                         Grade (Grade)        =      0.0                      	Threshold on displayable grade
visibleButtons                 Integer (buttons)      =      5                        	Max number of buttons in the shape selector

[org.audiveris.omr.glyph.ui.NestView]
showSentenceBaseline           Boolean                =      true                     	Should we show sentence baseline (vs inter-word gaps)?

[org.audiveris.omr.image.AdaptiveDescriptor]
meanCoeff                        Ratio                =      0.7                      	Threshold formula coefficient for mean pixel value
stdDevCoeff                      Ratio                =      0.9                      	Threshold formula coefficient for pixel standard deviation

[org.audiveris.omr.image.AdaptiveFilter]
halfWindowSize                 Integer (Pixels)       =      18                       	Half size of window around a given pixel

[org.audiveris.omr.image.FilterDescriptor]
defaultKind                       Enum                =      ADAPTIVE                 	Default kind of PixelFilter (GLOBAL or ADAPTIVE)

[org.audiveris.omr.image.Ghostscript]
maxVersion                      Double (version)      =      9999.0                   	Maximum Ghostscript acceptable version
minVersion                      Double (version)      =      9.06                     	Minimum Ghostscript acceptable version

[org.audiveris.omr.image.GlobalDescriptor]
defaultThreshold               Integer (GrayLevel)    =      140                      	Default threshold value (in 0..255)

[org.audiveris.omr.image.ImageLoading]
pdfResolution                  Integer (DPI)          =      300                      	DPI resolution for PDF images

[org.audiveris.omr.image.Template]
backWeight                       Ratio                =      1.0                      	Weight assigned to template exterior background pixels
dilation                      Fraction (Interline)    =      0.15                     	Dilation applied on a note head to be erased
foreWeight                       Ratio                =      6.0                      	Weight assigned to template foreground pixels
holeWeight                       Ratio                =      4.0                      	Weight assigned to template interior background pixels
maxDistanceHigh                 Double (distance)     =      0.5                      	Maximum matching distance
maxDistanceLow                  Double (distance)     =      0.4                      	Good matching distance
reallyBadDistance               Double (distance)     =      1.0                      	Really bad matching distance

[org.audiveris.omr.image.TemplateFactory]
binarizationThreshold          Integer (pixel value)  =      140                      	Binarization threshold for building head templates
defaultPointSize               Integer (pointSize)    =      80                       	Default point size
magnificationRatio             Integer (ratio)        =      50                       	Magnification ratio of template images for visual check
maxRawDistanceFromSymbol       Integer (distance)     =      8                        	Maximum raw distance from symbol for a keypoint
minCellPerSide                 Integer (pixels)       =      2                        	Minimum number of foreground pixels for slim bounds
prePopulateKeyPoints           Boolean                =      false                    	Should we populate keyPoints at template creation?
saveTemplates                  Boolean                =      false                    	Should we save the templates images to disk?
stemDx                           Ratio                =      -0.1                     	(Ratio) abscissa of stem anchor WRT symbol width (negative for inside)
stemDy                           Ratio                =      -0.2                     	(Ratio) ordinate of stem anchor WRT symbol height (negative for inside)

[org.audiveris.omr.lag.JunctionRatioPolicy]
maxLengthRatio                   Ratio                =      1.25                     	Maximum ratio in length for a run to be combined with an existing section

[org.audiveris.omr.lag.LagManager]
horizontalVipSections           String                =                               	(Debug) Comma-separated values of VIP horizontal sections IDs
ledgerThickness                  Ratio                =      1.2                      	Ratio of ledger thickness vs staff line MAXIMUM thickness
maxVerticalRunShift           Fraction (Interline)    =      0.05                     	Max shift between two runs of vertical sections
verticalVipSections             String                =                               	(Debug) Comma-separated values of VIP vertical sections IDs

[org.audiveris.omr.log.LogPane]
fontName                        String                =      Lucida Console           	Font name for log pane
fontSize                       Integer (Points)       =      10                       	Font size for log pane

[org.audiveris.omr.moments.BasicARTExtractor]
printWatch                     Boolean                =      false                    	Should we print out the stop watch?

[org.audiveris.omr.plugin.PluginsManager]
defaultPlugin                   String                =                               	Name of default plugin

[org.audiveris.omr.score.DrumSet]
dumpDrumSet                    Boolean                =      true                     	Should we dump the resulting drum set?

[org.audiveris.omr.score.LogicalPart]
defaultDoubleStaffPartName       String                =      Piano                    	Default name for a part with two staves
defaultDoubleStaffPartProgram      Integer (MidiProgram)  =      1                        	Default program number for a part with two staves
defaultPartName                 String                =      NoName                   	Default name for a part with more than two staves
defaultPartProgram             Integer (MidiProgram)  =      1                        	Default program number for a part with more than two staves
defaultSingleStaffPartName       String                =      Voice                    	Default name for a part with one staff
defaultSingleStaffPartProgram      Integer (MidiProgram)  =      54                       	Default program number for a part with one staff

[org.audiveris.omr.score.PartCollation]
pianoStaffConfig                String                =      5,5                      	Typical staff configuration for the piano part

[org.audiveris.omr.score.PartwiseBuilder]
avoidTupletBrackets            Boolean                =      false                    	Should we avoid brackets for all tuplets
pageHorizontalMargin           Integer (tenths)       =      80                       	Page horizontal margin
pageVerticalMargin             Integer (tenths)       =      80                       	Page vertical margin

[org.audiveris.omr.score.Score]
defaultTempo                   Integer (QuartersPerMn) =      120                      	Default tempo, stated in number of quarters per minute
defaultVolume                  Integer (Volume)       =      78                       	Default Volume in 0..127 range

[org.audiveris.omr.score.Tempo]
defaultTempo                   Integer (QuartersPerMn) =      120                      	Default tempo, stated in number of quarters per minute

[org.audiveris.omr.score.ui.EditorMenu]
maxEndShift                   Fraction (Interline)    =      1.0                      	Maximum deskewed abscissa difference between measure end
maxStaffDx                    Fraction (Interline)    =      1.0                      	Abscissa margin around staff sides

[org.audiveris.omr.score.ui.LogicalPartsEditor]
maxLineCount                   Integer (count)        =      6                        	Maximum staff line count
maxMidi                        Integer (id)           =      128                      	Maximum MIDI program number

[org.audiveris.omr.sheet.AliasPatterns]
useAliasPatterns               Boolean                =      true                     	Should we apply alias patterns on input names?

[org.audiveris.omr.sheet.Book]
batchUpgradeBooks              Boolean                =      false                    	In batch, should we automatically upgrade all book sheets?
checkBookVersion               Boolean                =      true                     	Should we check version of loaded book files?
printWatch                     Boolean                =      false                    	Should we print out the stop watch for book loading?
processAllStubsInParallel      Boolean                =      false                    	Should we process all stubs of a book in parallel? (beware of many stubs)
resetOldBooks                  Boolean                =      false                    	In batch, should we reset to binary the too old book files?

[org.audiveris.omr.sheet.BookManager]
baseFolder                      String                =      F:\Documents\Audiveris   	Base for output folders
bookHistory                     String                =[USR] F:\Documents\Audiveris\Hang on to your love\Hang on to your love.omr#1	History of books most recently loaded or saved
defaultBookFolder               String                =[USR] F:\Documents\Audiveris\Hang on to your love	Default folder for selection of book files
defaultImageFolder              String                =[USR] C:\Users\Name\Downloads  	Default folder for selection of image files
defaultSigned                  Boolean                =      true                     	Should we inject ProxyMusic signature in the exported scores?
historySize                    Integer (count)        =      10                       	Maximum number of files names kept in history
imageHistory                    String                =[USR] C:\Users\Name\Downloads\Hang on to your love.jpg;C:\Users\Name\Downloads\cph.jpg;E:\tmp\share\love.jpg;E:\tmp\share\pappie.pdf	History of images most recently loaded
useCompression                 Boolean                =      true                     	Should we compress the MusicXML output?
useInputBookFolder             Boolean                =      false                    	Should we store book outputs next to book input?
useOpus                        Boolean                =      false                    	Should we use Opus notion for export (rather than separate files)?
useSeparateBookFolders         Boolean                =      true                     	Should we use a separate folder for each book?

[org.audiveris.omr.sheet.PageCleaner]
dilationRatio                    Ratio                =      1.1                      	Size augmentation to use with eraser music font
lineMargin                    Fraction (Interline)    =      0.1                      	Thickness of white lines drawn on items borders
symbolSize                    Fraction (Interline)    =      1.1                      	Symbols size to use with eraser music font

[org.audiveris.omr.sheet.Picture]
gaussianRadius                 Integer (pixels)       =      1                        	Radius of Gaussian filtering kernel (1 for 3x3, 2 for 5x5, etc)
medianRadius                   Integer (pixels)       =      1                        	Radius of Median filtering kernel (1 for 3x3, 2 for 5x5)
printWatch                     Boolean                =      false                    	Should we print out the stop watch(es)?

[org.audiveris.omr.sheet.ProcessingSwitches]
articulations                  Boolean                =      true                     	Articulations
bothSharedHeadDots             Boolean                =      false                    	Link augmentation dot to both shared heads
chordNames                     Boolean                =      false                    	Chord names
crossHeads                     Boolean                =      false                    	Cross note heads
drumNotation                   Boolean                =      false                    	5-line unpitched percussion staves
fingerings                     Boolean                =      false                    	Fingering digits
fourStringTablatures           Boolean                =      false                    	4-line bass tablatures
frets                          Boolean                =      false                    	Frets roman digits (I, II, IV...)
implicitTuplets                Boolean                =      false                    	Implicit tuplets
indentations                   Boolean                =      true                     	Use of system indentation
keepGrayImages                 Boolean                =      false                    	Keep loaded gray images
lyrics                         Boolean                =      true                     	Lyrics
lyricsAboveStaff               Boolean                =      false                    	Lyrics even located above staff
multiWholeHeadChords           Boolean                =      false                    	Multi-whole head chords
oneLineStaves                  Boolean                =      false                    	1-line percussion staves
partialWholeRests              Boolean                =      false                    	Partial whole rests
pluckings                      Boolean                =      false                    	Plucking (p, i, m, a)
sixStringTablatures            Boolean                =      false                    	6-line guitar tablatures
smallBeams                     Boolean                =      false                    	Small beams
smallHeads                     Boolean                =      false                    	Small heads
tremolos                       Boolean                =      false                    	Tremolos

[org.audiveris.omr.sheet.Profiles]
defaultQuality                    Enum                =      Standard                 	Default quality for input image

[org.audiveris.omr.sheet.Scale]
defaultBeamSpecification       Integer (pixels)       =      0                        	Default specification of beam thickness (0 means no specification)

[org.audiveris.omr.sheet.ScaleBuilder]
beamMaxDiff                    Integer (pixels)       =      2                        	Maximum difference between beam guess and measurement
beamMaxFraction                  Ratio                =      1.0                      	Maximum ratio between beam height and interline
beamMinCountRatio                Ratio                =      0.007                    	Minimum ratio of runs for beam height measurement (quorum)
beamMinFraction                  Ratio                =      0.275                    	Minimum ratio between beam height and interline
beamRangeRatio                   Ratio                =      0.5                      	Ratio of beam possible height range for guess
maxInterline                   Integer (Pixels)       =      100                      	Maximum interline value (in pixels)
maxSecondRatio                   Ratio                =      1.9                      	Maximum ratio between second and first combined peak
minBlackRatio                    Ratio                =      0.001                    	Minimum ratio of foreground pixels in image
minDerivativeRatio               Ratio                =      0.025                    	Minimum ratio of total runs for derivative acceptance
minGainRatio                     Ratio                =      0.03                     	Minimum ratio of peak runs for peak extension
minInterline                   Integer (Pixels)       =      11                       	Minimum interline value (in pixels)

[org.audiveris.omr.sheet.Sheet]
useMarshalLogger               Boolean                =      false                    	Should we log every sheet marshalling?
useUnmarshalLogger             Boolean                =      false                    	Should we log every sheet unmarshalling?

[org.audiveris.omr.sheet.SheetDiff]
binaryThreshold                Integer (gray level)   =      127                      	Global threshold to binarize delta results
printWatch                     Boolean                =      false                    	Should we print out the stop watch?

[org.audiveris.omr.sheet.SheetStub]
printWatch                     Boolean                =      false                    	Should we print out the stop watch for sheet loading

[org.audiveris.omr.sheet.Staff]
definingPointSize             Fraction (Interline)    =      0.05                     	Display width of a defining point

[org.audiveris.omr.sheet.StaffManager]
showStaffLines                 Boolean                =      true                     	Should we show the staff lines on all views?
verticalAreaMargin            Fraction (Interline)    =      0.9                      	Vertical margin on staff areas

[org.audiveris.omr.sheet.SystemManager]
minIndentation                Fraction (Interline)    =      2.0                      	Minimum shift to detect a system indentation

[org.audiveris.omr.sheet.Versions]
lastReleaseCheckDate              Date                =[???] 09-Dec-2023              	Date when last release check was made
releaseCheckFrequency             Enum                =      Weekly                   	Frequency of release check

[org.audiveris.omr.sheet.beam.BeamStructure]
maxBorderJitter                  Ratio                =      0.8                      	Maximum border vertical jitter, specified as ratio of typical beam height
maxSectionSlopeGap              Double (tangent)      =      0.3                      	Maximum delta slope between sections of same border

[org.audiveris.omr.sheet.beam.BeamsBuilder]
beamsXMargin                  Fraction (Interline)    =      0.25                     	Abscissa margin around beams to exclude beam stems
beltMarginDx                  Fraction (Interline)    =      0.25                     	Horizontal belt margin checked around beam
beltMarginDy                  Fraction (Interline)    =      0.15                     	Vertical belt margin checked around beam
coreSectionWidth              Fraction (Interline)    =      0.15                     	Minimum width for a core section to define borders
cornerMarginRatio                Ratio                =      0.2                      	Corner margin for a beam or hook, specified as ratio of typical beam
cueBeamRatio                     Ratio                =      0.6                      	Ratio applied for cue beams height
cueBoxDx                      Fraction (Interline)    =      0.25                     	Abscissa expansion of aggregate box
cueBoxDy                      Fraction (Interline)    =      1.0                      	Ordinate shift of aggregate box
cueMinBeamHeadDy              Fraction (Interline)    =      1.0                      	Minimum vertical distance between cue beam and head
cueXMargin                    Fraction (Interline)    =      2.0                      	Abscissa margin to aggregate cues
cueYMargin                    Fraction (Interline)    =      3.0                      	Ordinate margin to aggregate cues
maxBeamSlope                    Double (tangent)      =      1.0                      	Maximum absolute tangent value for a beam angle
maxBeamsGapX                  Fraction (Interline)    =      1.0                      	Maximum abscissa gap to merge aligned beams
maxBeamsGapY                  Fraction (Interline)    =      0.25                     	Maximum ordinate mismatch to merge aligned beams
maxBeltBlackRatio                Ratio                =      0.4                      	Maximum ratio of black pixels around beam
maxBorderSlopeGap               Double (tangent)      =      0.15                     	Maximum delta slope between top and bottom borders of a beam
maxDistanceToBorder           Fraction (Interline)    =      0.15                     	Maximum mean distance to average beam border
maxExtensionToSpot            Fraction (Interline)    =      0.5                      	Maximum beam horizontal extension to spot
maxExtensionToStem            Fraction (Interline)    =      1.0                      	Maximum beam horizontal extension to stem seed
maxHeightRatioHigh               Ratio                =      1.4                      	High maximum height for a beam or hook, specified as ratio of typical beam
maxHookWidth                  Fraction (Interline)    =      2.0                      	Maximum width for a hook
maxItemXGap                   Fraction (Interline)    =      0.5                      	Acceptable abscissa gap within a beam item
maxJitterRatio                   Ratio                =      0.02                     	Maximum border jitter ratio
maxSideBeamDx                 Fraction (Interline)    =      4.0                      	Maximum abscissa gap to detect side beams
maxStemBeamGapX               Fraction (Interline)    =      0.2                      	Maximum abscissa gap between stem and beam
maxStemBeamGapY               Fraction (Interline)    =      0.8                      	Maximum ordinate gap between stem and beam
minBeamWidthHigh              Fraction (Interline)    =      4.0                      	High minimum width for a beam
minBeamWidthLow               Fraction (Interline)    =      1.0                      	Low minimum width for a beam
minBeamsGapX                  Fraction (Interline)    =      0.2                      	Minimum abscissa gap to check inner area
minCoreBlackRatio                Ratio                =      0.7                      	Minimum ratio of black pixels inside beam
minExtBlackRatio                 Ratio                =      0.6                      	Minimum ratio of black pixels inside beam extension
minHeightRatioLow                Ratio                =      0.7                      	Low minimum height for a beam or hook, specified as ratio of typical beam
minHookWidthHigh              Fraction (Interline)    =      1.0                      	High minimum width for a hook
minHookWidthLow               Fraction (Interline)    =      0.7                      	Low minimum width for a hook

[org.audiveris.omr.sheet.beam.BlackHeadSizer]
binarizationThreshold          Integer (pixel)        =      110                      	Global binarization threshold for heads
closingDiameter               Fraction (Interline)    =      0.9                      	Closing diameter for black head spot
maxHeight                     Fraction (Interline)    =      1.5                      	Maximum height for black head spot
maxStackHeight                Fraction (Interline)    =      4.0                      	Maximum height for vertical stack of black head spots
maxStackWeight            AreaFraction (Interline**2) =      4.0                      	Maximum weight for vertical stack of black head spots
maxWeight                 AreaFraction (Interline**2) =      1.5                      	Maximum weight for black head spot
maxWidth                      Fraction (Interline)    =      2.0                      	Maximum width for black head spot
minHeight                     Fraction (Interline)    =      0.9                      	Minimum height for black head spot
minStackHeight                Fraction (Interline)    =      2.0                      	Minimum height for vertical stack of black head spots
minStackWeight            AreaFraction (Interline**2) =      2.0                      	Minimum weight for vertical stack of black head spots
minWeight                 AreaFraction (Interline**2) =      0.8                      	Minimum weight for black head spot
minWidth                      Fraction (Interline)    =      1.0                      	Minimum width for black head spot
singlesQuorum                  Integer (glyphs)       =      20                       	Quorum for usable singles

[org.audiveris.omr.sheet.beam.CueBeamsStep]
displayCueBeamSpots            Boolean                =      false                    	Should we display the cue beam Spots view?

[org.audiveris.omr.sheet.beam.MultipleRestsBuilder]
maxAbsolutePitch                Double (pitch)        =      0.2                      	Maximum absolute pitch position of beam center
minLength                     Fraction (Interline)    =      4.0                      	Minimum multirest length

[org.audiveris.omr.sheet.beam.SpotsBuilder]
beamBinarizationThreshold      Integer (pixel)        =      140                      	Global binarization threshold for beams
beamCircleDiameterRatio          Ratio                =      0.8                      	Diameter of circle used to close beam spots, as ratio of beam height
displayBeamSpots               Boolean                =      false                    	Should we display the beam Spots view?
displayGraySpots               Boolean                =      false                    	Should we display the gray Spots view?
headBinarizationThreshold      Integer (pixel)        =      170                      	Global binarization threshold for heads
printWatch                     Boolean                =      false                    	Should we print out the stop watch?
saveBeamSpots                  Boolean                =      false                    	Should we save sheet beam spot images on disk?
saveCueSpots                   Boolean                =      false                    	Should we save cue spot images on disk?
saveHeadSpots                  Boolean                =      false                    	Should we save sheet head spot images on disk?
staffVerticalMargin           Fraction (Interline)    =      2.0                      	Margin erased above & below staff header area

[org.audiveris.omr.sheet.clef.ClefBuilder]
aboveStaff                    Fraction (Interline)    =      3.0                      	Top of lookup area above stave
belowStaff                    Fraction (Interline)    =      3.25                     	Bottom of lookup area below stave
beltMargin                    Fraction (Interline)    =      0.15                     	White margin within raw rectangle
maxClefEnd                    Fraction (Interline)    =      4.5                      	Maximum x distance from measure start to end of clef
maxEvalRank                    Integer (none)         =      3                        	Maximum acceptable rank in clef evaluation
maxGlyphHeight                Fraction (Interline)    =      9.0                      	Maximum height for clef glyph
maxPartCount                   Integer (Glyphs)       =      8                        	Maximum number of parts considered for a clef
maxPartGap                    Fraction (Interline)    =      1.0                      	Maximum distance between two parts of a single clef symbol
minGlyphWeight            AreaFraction (Interline**2) =      1.0                      	Minimum weight for clef glyph
minPartWeight             AreaFraction (Interline**2) =      0.01                     	Minimum weight for a glyph part
xCoreMargin                   Fraction (Interline)    =      0.2                      	Horizontal margin around core rectangle
yCoreMargin                   Fraction (Interline)    =      0.5                      	Vertical margin around core rectangle

[org.audiveris.omr.sheet.curve.ArcRetriever]
arcMinQuorum                  Fraction (Interline)    =      1.75                     	Minimum arc length for quorum
maxAlpha                        Double (degree)       =      4.0                      	Maximum angle (in degrees) for 3 points colinearity
maxLineDistance               Fraction (Interline)    =      0.1                      	Maximum distance from straight line
maxRunLength                  Fraction (Interline)    =      0.6                      	Maximum length for a vertical run
maxStaffArcLength             Fraction (Interline)    =      5.0                      	Maximum length for a staff arc
minSlope                        Double ((co)tangent)  =      0.03                     	Minimum (inverted) slope, to detect vertical and horizontal lines
minStaffArcLength             Fraction (Interline)    =      0.5                      	Minimum length for a staff arc
minStaffLineDistance          Fraction (Interline)    =      0.15                     	Minimum distance from staff line

[org.audiveris.omr.sheet.curve.ChordSplitter]
minSubStemLength              Fraction (Interline)    =      2.5                      	Minimum sub-stem length for a tie split

[org.audiveris.omr.sheet.curve.Curves]
breakPointCoordinates           String                =                               	(Debug) Comma-separated coordinates of curve break points if any
defaultThickness                Double (pixels)       =      2.0                      	Default thickness for a curve display
displayCurves                  Boolean                =      false                    	Should we display the view on curves?
printWatch                     Boolean                =      false                    	Should we print out the stop watch?

[org.audiveris.omr.sheet.curve.CurvesBuilder]
gapBoxDeltaIn                 Fraction (Interline)    =      0.2                      	Delta for gap box on slur side
gapBoxDeltaOut                Fraction (Interline)    =      0.3                      	Delta for gap box on extension side
gapBoxLength                  Fraction (Interline)    =      1.0                      	Length used for gap lookup box
gapMaxLength                  Fraction (Interline)    =      0.25                     	Maximum acceptable length for true gap
lineBoxDeltaIn                Fraction (Interline)    =      0.2                      	Delta for line box on slur side
lineBoxDeltaOut               Fraction (Interline)    =      0.3                      	Delta for line box on extension side
lineBoxIn                     Fraction (Interline)    =      0.2                      	Overlap for line box on slur side
lineBoxLength                 Fraction (Interline)    =      1.8                      	Length for box across staff line
maxExtensionRookies            Integer (extensions)   =      50                       	Maximum rookies when extending a curve

[org.audiveris.omr.sheet.curve.EndingsBuilder]
legYMargin                    Fraction (Interline)    =      0.25                     	Vertical margin for leg lookup area
maxCoordGap                   Fraction (Interline)    =      0.5                      	Maximum delta coordinate for a gap between filaments
maxLegXGap                    Fraction (Interline)    =      0.5                      	Maximum abscissa gap between ending and leg
maxLegYGap                    Fraction (Interline)    =      0.5                      	Maximum ordinate gap between ending and leg
maxOverlapDeltaPos        LineFraction (Line)         =      1.0                      	Maximum delta position between two overlapping filaments
maxOverlapSpace           LineFraction (Line)         =      0.3                      	Maximum space between overlapping filaments
maxSlope                        Double (tangent)      =      0.02                     	Maximum ending slope
minFirstMeasureRatio             Ratio                =      0.6                      	Minimum ending length as ratio of related measure length, for first in system
minGapFromStaff               Fraction (Interline)    =      2.5                      	Minimum vertical gap between ending line and staff below
minLegLow                     Fraction (Interline)    =      1.0                      	Low minimum leg length
minLengthHigh                 Fraction (Interline)    =      10.0                     	High minimum ending length
minLengthLow                  Fraction (Interline)    =      6.0                      	Low minimum ending length
minMeasureRatio                  Ratio                =      0.8                      	Minimum ending length as ratio of related measure length
stemRatio                        Ratio                =      1.4                      	Maximum leg thickness as ratio of stem thickness

[org.audiveris.omr.sheet.curve.SegmentsBuilder]
arcMinSeedLength              Fraction (Interline)    =      1.25                     	Minimum arc length for starting a wedge build
maxExtDistance                Fraction (Interline)    =      0.35                     	Maximum line distance for extension arc
maxRunDistance                Fraction (Interline)    =      0.2                      	Maximum distance from any run end to curve points
maxSegmentDistance            Fraction (Interline)    =      0.3                      	Maximum line distance for final segment
maxWedgeAngle                   Double (degree)       =      20.0                     	Maximum angle (in degrees) for a wedge branch with x-axis
minProjection                 Fraction (Interline)    =      -1.0                     	Minimum projection on curve for arc extension
minRunRatio                      Ratio                =      0.75                     	Minimum runs count as ratio of segment width

[org.audiveris.omr.sheet.curve.Skeleton]
maxDxFromStaff                Fraction (Interline)    =      1.0                      	Maximum horizontal gap from any staff
maxDyFromStaff                Fraction (Interline)    =      10.0                     	Maximum vertical gap from any staff
maxDyFromTablature            Fraction (Interline)    =      1.0                      	Maximum vertical gap from any tablature
saveSkeleton                   Boolean                =      false                    	Should we save skeleton images on disk?
systemVerticalMargin          Fraction (Interline)    =      2.0                      	Margin erased above & below system header area
useHeader                      Boolean                =      true                     	Should we erase the header at staff start

[org.audiveris.omr.sheet.curve.SlurLinker]
coverageHDepth                Fraction (Interline)    =      3.0                      	Vertical extension of horizontal slur coverage
coverageHExt                  Fraction (Interline)    =      2.0                      	Length of extension for horizontal slur coverage
coverageHIn                   Fraction (Interline)    =      0.5                      	Internal abscissa of horizontal slur coverage
coverageVDepth                Fraction (Interline)    =      2.5                      	Vertical extension of vertical slur coverage
coverageVDepthSmall           Fraction (Interline)    =      1.5                      	Vertical extension of small vertical slur coverage
coverageVExt                  Fraction (Interline)    =      2.0                      	Length of extension for vertical slur coverage
coverageVIn                   Fraction (Interline)    =      1.5                      	Internal abscissa of vertical slur coverage
maxOrphanDx                   Fraction (Interline)    =      6.0                      	Maximum dx to staff end for an orphan slur
maxOrphanSlope                  Double (tangent)      =      0.5                      	Maximum slope for an orphan slur
maxSmallSlurWidth             Fraction (Interline)    =      1.5                      	Maximum width for a small slur
slopeSeparator                  Double (tangent)      =      0.5                      	Slope that separates vertical slurs from horizontal slurs
targetExtension               Fraction (Interline)    =      0.5                      	Extension length from slur end to slur target point
wideSlurWidth                 Fraction (Interline)    =      6.0                      	Minimum width to be a wide slur

[org.audiveris.omr.sheet.curve.SlursBuilder]
arcCheckLength                Fraction (Interline)    =      2.0                      	Length checked for extension arc
arcMinSeedLength              Fraction (Interline)    =      0.5                      	Minimum arc length for starting a slur build
maxArcAngleHigh                 Double (degree)       =      190.0                    	High maximum angle (in degrees) of slur arc
maxArcAngleLow                  Double (degree)       =      170.0                    	Low maximum angle (in degrees) of slur arc
maxArcsDistance               Fraction (Interline)    =      0.15                     	Maximum circle distance for intermediate arcs
maxExtDistance                Fraction (Interline)    =      0.45                     	Maximum circle distance for extension arc
maxIncidence                    Double (degree)       =      15.0                     	Maximum incidence angle (in degrees) for staff tangency
maxRunDistance                Fraction (Interline)    =      0.25                     	Maximum distance from any run end to curve points
maxSlurDistance               Fraction (Interline)    =      0.1                      	Maximum circle distance for private final slur
maxStaffLineDy                Fraction (Interline)    =      0.2                      	Vertical distance to closest staff line to detect tangency
minAngleFromVerticalHigh        Double (degree)       =      25.0                     	High minimum angle (in degrees) between slur and vertical
minAngleFromVerticalLow         Double (degree)       =      10.0                     	Low minimum angle (in degrees) between slur and vertical
minCircleRadius               Fraction (Interline)    =      0.4                      	Minimum circle radius for a slur
minProjection                 Fraction (Interline)    =      -1.0                     	Minimum projection on curve for arc extension
minRunRatio                      Ratio                =      0.75                     	Minimum runs count as ratio of slur width
minSeedCircleRadius           Fraction (Interline)    =      0.3                      	Minimum circle radius for a slur seed
minSlurHeightHigh             Fraction (Interline)    =      1.0                      	High minimum height for a slur
minSlurHeightLow              Fraction (Interline)    =      0.07                     	Low minimum height for a slur
minSlurWidthHigh              Fraction (Interline)    =      1.5                      	High minimum width for a slur
minSlurWidthLow               Fraction (Interline)    =      0.7                      	Low minimum width for a slur
quorumRatio                      Ratio                =      0.5                      	Minimum length expressed as ratio of longest in clump
sideModelLength               Fraction (Interline)    =      6.0                      	Length for side osculatory model
similarRadiusRatio               Ratio                =      0.25                     	Maximum difference ratio between radius of similar circles
tangentLength                 Fraction (Interline)    =      0.5                      	Length for checking staff line tangency

[org.audiveris.omr.sheet.curve.WedgesBuilder]
closedMaxDx                   Fraction (Interline)    =      0.2                      	Maximum abscissa gap between segments ends on closed side
closedMaxDy                   Fraction (Interline)    =      0.5                      	Maximum ordinate gap between segments ends on closed side
minLengthHigh                 Fraction (Interline)    =      3.0                      	High minimum horizontal length
minLengthLow                  Fraction (Interline)    =      2.0                      	Low minimum horizontal length
openMaxBias                     Double (degrees)      =      20.0                     	Maximum vertical bias (in degrees) between segments ends on open side
openMinDyHigh                 Fraction (Interline)    =      1.5                      	High minimum ordinate gap between segments ends on open side
openMinDyLow                  Fraction (Interline)    =      0.5                      	Low minimum ordinate gap between segments ends on open side

[org.audiveris.omr.sheet.grid.BarFilamentFactory]
minCoreSectionLength          Fraction (Interline)    =      0.5                      	Minimum length for a section to be considered as core
printWatch                     Boolean                =      false                    	Should we print out the stop watch?
segmentLength                 Fraction (Interline)    =      1.0                      	Typical length between filament curve intermediate points

[org.audiveris.omr.sheet.grid.BarsRetriever]
braceBarNeutralGap            Fraction (Interline)    =      0.1                      	Horizontal neutral area between a brace and next bar
braceLeftMargin               Fraction (Interline)    =      0.5                      	Margin on left side of brace peak to retrieve full glyph
braceLookupExtension          Fraction (Interline)    =      0.5                      	Lookup height for brace end above or below staff line
braceSegmentLength            Fraction (Interline)    =      1.0                      	Typical distance between brace points
cClefTail                     Fraction (Interline)    =      2.0                      	Typical width for tail of C-Clef, from second peak to right end
forceSeparateParts             Boolean                =      false                    	Should we force all staves to use separate parts?
forceSinglePart                Boolean                =      false                    	Should we force single part for 2-staff systems without brace?
largeSystemStaffCount          Integer (staves)       =      4                        	Minimum number of staves for a system to be large
maxBarExtension               Fraction (Interline)    =      1.0                      	Maximum extension for a barline above or below staff line
maxBraceBarGap                Fraction (Interline)    =      2.0                      	Max horizontal gap between a brace peak and next bar
maxBraceCurvature             Fraction (Interline)    =      25.0                     	Maximum mean curvature radius for a brace
maxBracePeakWidth             Fraction (Interline)    =      3.0                      	Maximum width of a brace peak
maxBraceThickness             Fraction (Interline)    =      1.0                      	Maximum thickness of a brace (for sections)
maxBracketExtension           Fraction (Interline)    =      1.25                     	Maximum extension for bracket trunk end above or below staff line
maxColumnDx                   Fraction (Interline)    =      0.75                     	Maximum abscissa shift within a column
maxDoubleBarGap               Fraction (Interline)    =      0.75                     	Max horizontal gap between two members of a double bar
maxLinesLeftToStartBar        Fraction (Interline)    =      0.15                     	Maximum dx between left end of staff lines and start bar
maxPeak2WidthForCClef         Fraction (Interline)    =      0.3                      	Maximum width for second peak of C-Clef
minBracePortionHeight         Fraction (Interline)    =      3.0                      	Minimum height for a brace portion
minBracketWidth               Fraction (Interline)    =      0.25                     	Minimum width for a bracket peak
minMeasureWidth               Fraction (Interline)    =      2.0                      	Minimum width for a measure
minPeak1WidthForCClef         Fraction (Interline)    =      0.3                      	Minimum width for first peak of C-Clef
minSeparateStaffGutter        Fraction (Interline)    =      2.5                      	Minimum vertical gap between two part staves to be separated
minThinThickDelta             Fraction (Interline)    =      0.2                      	Minimum difference between THIN/THICK width values
printWatch                     Boolean                =      false                    	Should we print out the stop watch?
serifMinWeight            AreaFraction (Interline**2) =      0.2                      	Minimum weight for bracket serif
serifRoiHeight                Fraction (Interline)    =      2.0                      	Height of lookup ROI for bracket serif
serifRoiWidth                 Fraction (Interline)    =      2.0                      	Width of lookup ROI for bracket serif
serifSegmentLength            Fraction (Interline)    =      1.0                      	Typical distance between bracket serif points
serifThickness                Fraction (Interline)    =      0.3                      	Typical thickness of bracket serif
showVerticalLines              Boolean                =      false                    	Should we show the vertical grid lines?

[org.audiveris.omr.sheet.grid.ClustersRetriever]
clusterYMargin                Fraction (Interline)    =      2.0                      	Rough margin around cluster ordinate
combMaxMargin                 Fraction (Interline)    =      0.0                      	Comb margin above maximum interline (use with caution)
combMinMargin                 Fraction (Interline)    =      0.0                      	Comb margin below minimum interline (use with caution)
maxClusterDiffLengthRatio        Ratio                =      0.5                      	Maximum ratio of difference in length within raw lines of a cluster
maxExpandDx                   Fraction (Interline)    =      2.0                      	Maximum dx to aggregate a filament to a cluster
maxExpandDy                   Fraction (Interline)    =      0.175                    	Maximum dy to aggregate a filament to a cluster
maxExtrapolationDx            Fraction (Interline)    =      6.0                      	Maximum dx to extrapolate filament ordinate
maxMergeCenterDy              Fraction (Interline)    =      1.0                      	Maximum center dy to merge two clusters
maxMergeDx                    Fraction (Interline)    =      6.0                      	Maximum dx to merge two multi-line clusters
maxMergeDxSingle              Fraction (Interline)    =      10.0                     	Maximum dx to merge two 1-line clusters
maxMergeDy                    Fraction (Interline)    =      0.4                      	Maximum dy to merge two clusters
minClusterLengthRatio            Ratio                =      0.2                      	Minimum cluster true length (as ratio of median true length)
minClusterTablatureLengthRatio        Ratio                =      0.5                      	Minimum tablature cluster true length (as ratio of median true length)
samplingDx                    Fraction (Interline)    =      1.0                      	Typical delta X between two vertical samplings

[org.audiveris.omr.sheet.grid.GridBuilder]
displayFilaments               Boolean                =      false                    	Should we show the filaments view?
printWatch                     Boolean                =      false                    	Should we print out the stop watch?
showGrid                       Boolean                =      false                    	Should we show the details of grid?

[org.audiveris.omr.sheet.grid.GridStep]
displayNoStaff                 Boolean                =      false                    	Should we display the staff-free image?

[org.audiveris.omr.sheet.grid.LinesRetriever]
displayRuns                    Boolean                =      false                    	Should we display all images on runs?
maxEndingDx                   Fraction (Interline)    =      1.0                      	Maximum abscissa delta between line end and staff end
maxFilamentRotation             Double (radians)      =      0.1                      	Maximum central rotation for filaments
maxRightIndentation           Fraction (Interline)    =      5.0                      	Maximum staff right indentation
maxSlopeDiff                    Double (radians)      =      0.025                    	Maximum delta slope between filament and sheet
maxStickerConnectionLength     Fraction (Interline)    =      0.05                     	Maximum connected pixels for a line sticker
maxStickerExtension       LineFraction (Line)         =      1.2                      	Maximum vertical sticker extension from line
maxStickerGap             LineFraction (Line)         =      0.25                     	Maximum vertical gap between sticker and closest line side
maxThinStickerWeight      AreaFraction (Interline**2) =      0.06                     	Maximum weight for a thin sticker (w/o impact on line geometry)
minLengthForSlopeCheck        Fraction (Interline)    =      4.0                      	Minimum filament length for strict slope check
minRadius                     Fraction (Interline)    =      12.0                     	Minimum acceptable radius of polished curvature
minRunLength                  Fraction (Interline)    =      0.25                     	Minimum length for a horizontal run to be considered
minSlope                        Double (tangent)      =      2.0E-4                   	Minimum absolute slope value to be worth noting
minStaffLength                Fraction (Interline)    =      30.0                     	Minimum staff length
patternJitter                 Fraction (Interline)    =      0.25                     	Maximum ordinate jitter for staff pattern
patternWidth                  Fraction (Interline)    =      1.0                      	Width of probe for staff pattern
printWatch                     Boolean                =      false                    	Should we print out the stop watch?
showCombs                      Boolean                =      false                    	Should we show staff lines combs?
showHorizontalLines            Boolean                =      true                     	Should we show the horizontal grid lines?
showTangents                   Boolean                =      false                    	Should we show filament ending tangents?
stickerThickness                 Ratio                =      1.0                      	Ratio of sticker thickness vs staff line MAXIMUM thickness
tangentLg                     Fraction (Interline)    =      1.0                      	Typical length to show tangents at ending points
topRatioForSlope                 Ratio                =      0.1                      	Percentage of top filaments used to retrieve global slope

[org.audiveris.omr.sheet.grid.PeakGraph]
bracketLookupExtension        Fraction (Interline)    =      2.0                      	Lookup height for bracket end above or below staff line
maxAlignmentBraceDx           Fraction (Interline)    =      0.75                     	Max abscissa shift for brace alignment
maxAlignmentDeltaWidth        Fraction (Interline)    =      0.6                      	Max delta width for bar alignment
maxAlignmentSlope                Ratio                =      0.06                     	Max slope for bar alignment
maxCloseGap                   Fraction (Interline)    =      0.4                      	Max horizontal gap between two close members of a double bar
maxConnectionGap              Fraction (Interline)    =      2.0                      	Max vertical gap when connecting bar lines
maxConnectionWhiteRatio          Ratio                =      0.35                     	Max white ratio when connecting bar lines
maxFirstConnectionXOffset     Fraction (Interline)    =      2.0                      	Max horizontal offset between staff start and first connection
maxTotalDiffRatio                Ratio                =      0.3                      	Max width difference ratio between aligned groups of peaks
maxWidthRatio                    Ratio                =      0.3                      	Max width difference ratio between aligned peaks
minBarCurvature               Fraction (Interline)    =      10.0                     	Minimum mean curvature radius for a bar line
minConnectionGrade               Ratio                =      0.5                      	Minimum grade for a true connection
printWatch                     Boolean                =      false                    	Should we print out the stop watch?

[org.audiveris.omr.sheet.grid.StaffFilament]
maxHoleLength                 Fraction (Interline)    =      6.0                      	Maximum length for holes without intermediate points
maxSimplificationShift          Double (pixels)       =      1.0                      	Maximum acceptable vertical shift when simplifying staff line points
segmentLength                 Fraction (Interline)    =      4.0                      	Typical length between filament curve intermediate points
virtualSegmentLength          Fraction (Interline)    =      5.0                      	Typical length used for virtual intermediate points

[org.audiveris.omr.sheet.grid.StaffLineCleaner]
printWatch                     Boolean                =      false                    	Should we print out the stop watch?

[org.audiveris.omr.sheet.grid.StaffProjector]
barChunkDx                    Fraction (Interline)    =      0.4                      	Abscissa margin for chunks check around bar
barRefineDx                   Fraction (Interline)    =      0.25                     	Abscissa margin for refining peak sides
barThreshold                  Fraction (Interline)    =      2.5                      	Minimum cumul value to detect bar peak
blankThreshold                   Ratio                =      0.5                      	Maximum ratio of lines cumul to detect no-line regions
braceThreshold                Fraction (Interline)    =      1.1                      	Minimum cumul value to detect brace peak
chunkThreshold                Fraction (Interline)    =      1.2                      	Maximum cumul value to detect chunk (on top of staff lines)
chunkWidth                    Fraction (Interline)    =      0.15                     	Abscissa with (>=1) on bar peak side where chunk is measured
gapThreshold                  Fraction (Interline)    =      0.6                      	Maximum vertical gap length in a bar
maxBarWidth                   Fraction (Interline)    =      1.5                      	Maximum bar width
maxLeftExtremum               Fraction (Interline)    =      0.15                     	Maximum length between actual lines left end and left ending bar
maxRightExtremum              Fraction (Interline)    =      0.3                      	Maximum length between right ending bar and actual lines right end
minDerivativeRatio               Ratio                =      0.3                      	Minimum absolute derivative as ratio of elite derivative
minSmallBlankWidth            Fraction (Interline)    =      0.1                      	Minimum width for a small blank region (right of lines)
minStandardBlankWidth         Fraction (Interline)    =      1.0                      	Minimum width for a standard blank region (left of lines)
minWhiteRatioBeyondVerticalSerif        Ratio                =      0.3                      	Minimum white ratio above and below a multiple rest vertical serif
minWideBlankWidth             Fraction (Interline)    =      2.0                      	Minimum width for a wide blank region (to limit peaks search)
staffAbscissaMargin           Fraction (Interline)    =      15.0                     	Abscissa margin for checks around staff
topDerivativeNumber            Integer (count)        =      5                        	Top number of best derivatives
useOneLineHalfMode             Boolean                =      true                     	Should we use a 'halfMode' for first peak of 1-line staves
verticalSerifWidth            Fraction (Interline)    =      0.25                     	Maximum width for a multiple rest vertical serif

[org.audiveris.omr.sheet.header.HeaderBuilder]
maxHeaderWidth                Fraction (Interline)    =      15.0                     	Maximum header width (from measure start to end of key-sig or time-sig)

[org.audiveris.omr.sheet.key.KeyBuilder]
coreStemLength                Fraction (Interline)    =      2.0                      	Core length for alteration "stem" (flat or sharp)
maxDeltaPitch_1                 Double (pitch)        =      0.5                      	Maximum adjustment in pitch for 1 item
maxDeltaPitch_4                 Double (pitch)        =      2.0                      	Maximum adjustment in pitch for 4+ items
maxFirstPeakOffset            Fraction (Interline)    =      2.3                      	Maximum x offset of first peak (WRT browse start)
maxFirstSpaceWidth            Fraction (Interline)    =      2.1                      	Maximum initial space before key signature
maxFlatHeading                Fraction (Interline)    =      0.2                      	Maximum heading length before peak for a flat item
maxFlatTrail                  Fraction (Interline)    =      1.3                      	Maximum trailing length after peak for a flat item
maxInnerPeakGap               Fraction (Interline)    =      1.35                     	Maximum inner peak gap within key signature
maxInnerSpace                 Fraction (Interline)    =      0.7                      	Maximum inner space within key signature
maxPeakCumul                  Fraction (Interline)    =      4.25                     	Maximum cumul value to accept peak (absolute value)
maxPeakDx                     Fraction (Interline)    =      1.5                      	Maximum delta abscissa between peaks
maxPeakWidth                  Fraction (Interline)    =      0.45                     	Maximum width to accept peak
maxSharpDelta                 Fraction (Interline)    =      0.7                      	Maximum short peak delta for sharps
maxSharpTrail                 Fraction (Interline)    =      0.5                      	Maximum trailing length after last peak for a sharp item
maxSliceDeltaWidth            Fraction (Interline)    =      0.15                     	Maximum width delta to replicate slice
maxSliceDeltaX                Fraction (Interline)    =      0.15                     	Maximum abscissa delta to replicate slice
maxSpaceCumul                 Fraction (Interline)    =      0.4                      	Maximum cumul value in space
maxSpaceInAlter               Fraction (Interline)    =      0.4                      	Maximum space within an alter
maxTrailingCumul              Fraction (Interline)    =      0.25                     	Maximum cumul threshold in trailing area
minBlackRatio                    Ratio                =      0.75                     	Minimum ratio of black rows in core length
minFlatDelta                  Fraction (Interline)    =      0.45                     	Minimum short peak delta for flats
minFlatLightPeakDx            Fraction (Interline)    =      0.5                      	Minimum delta abscissa with closest flat peak to keep a light peak
minFlatTrail                  Fraction (Interline)    =      0.7                      	Minimum trailing length after peak for a flat item
minGainRatio                     Ratio                =      0.2                      	Minimum gain ratio when extending peaks
minPeakCumul                  Fraction (Interline)    =      1.25                     	Minimum cumulated value for a peak
minPeakDerivative             Fraction (Interline)    =      0.35                     	Minimum derivative for peak detection
minSharpLightPeakDx           Fraction (Interline)    =      0.25                     	Minimum delta abscissa with closest sharp peak to keep a light peak
minSharpTrail                 Fraction (Interline)    =      0.2                      	Minimum trailing length after last peak for a sharp item
minTrailingSpace              Fraction (Interline)    =      0.25                     	Minimum space length after last key item (before potential note head)
peakAreaQuorum                   Ratio                =      0.5                      	Quorum ratio of peak area WRT peaks mean area
preStaffMargin                Fraction (Interline)    =      2.0                      	Horizontal margin before staff left (for plot display)
stdFlatTrail                  Fraction (Interline)    =      1.0                      	Standard trailing length after peak for a flat item
stdGlyphHeight                Fraction (Interline)    =      2.5                      	Standard alteration height (flat or sharp)
stdSharpTrail                 Fraction (Interline)    =      0.3                      	Standard trailing length after last peak for a sharp item
vipStaves                       String                =                               	(Debug) Comma-separated values of VIP staff IDs

[org.audiveris.omr.sheet.key.KeyColumn]
maxSliceDist                  Fraction (Interline)    =      0.5                      	Maximum abscissa distance to theoretical slice

[org.audiveris.omr.sheet.key.KeyExtractor]
maxEvalRank                    Integer (none)         =      3                        	Maximum acceptable rank in key alter evaluation
maxGlyphHeight                Fraction (Interline)    =      3.8                      	Maximum glyph height
maxGlyphWeight            AreaFraction (Interline**2) =      3.4                      	Maximum glyph weight
maxGlyphWidth                 Fraction (Interline)    =      2.0                      	Maximum glyph width
maxPartCount                   Integer (Glyphs)       =      8                        	Maximum number of parts considered for an alter symbol
maxPartGap                    Fraction (Interline)    =      1.5                      	Maximum distance between two parts of a single alter symbol
minGlyphHeight                Fraction (Interline)    =      1.0                      	Minimum glyph height
minGlyphWeight            AreaFraction (Interline**2) =      0.2                      	Minimum glyph weight
minGlyphWidth                 Fraction (Interline)    =      0.5                      	Minimum glyph width
minPartWeight             AreaFraction (Interline**2) =      0.01                     	Minimum weight for an alter part

[org.audiveris.omr.sheet.ledger.LedgersBuilder]
convexityLow                    Double (end number)   =      -0.5                     	Minimum convexity ends
ledgerMarginY                 Fraction (Interline)    =      0.35                     	Margin on ledger ordinate WRT theoretical ordinate
maxDistanceHigh               Fraction (Interline)    =      0.3                      	Low Minimum radius for ledger
maxInterLedgerDx              Fraction (Interline)    =      2.5                      	Maximum inter-ledger abscissa gap for ordinate compatibility test
maxLedgerLength               Fraction (Interline)    =      20.0                     	Maximum ledger length
maxSlopeForCheck                Double (tangent)      =      0.1                      	Maximum slope for visual check
maxThicknessHigh          LineFraction (Line)         =      3.25                     	High Maximum thickness of an interesting stick (WRT staff line)
maxThicknessHigh2             Fraction (Interline)    =      0.4                      	High Maximum thickness of an interesting stick (WRT interline)
maxThicknessLow           LineFraction (Line)         =      1.0                      	Low Maximum thickness of an interesting stick (WRT staff line)
minAbscissaOverlap            Fraction (Interline)    =      0.75                     	Minimum abscissa overlap of a ledger with the previous one
minCoreSectionLength          Fraction (Interline)    =      1.0                      	Minimum length for a section to be considered as core
minLedgerLengthHigh           Fraction (Interline)    =      1.5                      	High Minimum length for a ledger
minLedgerLengthHigh2          Fraction (Interline)    =      2.0                      	High Minimum long length for a ledger
minLedgerLengthLow            Fraction (Interline)    =      1.0                      	Low Minimum length for a ledger
minLedgerLengthLow2           Fraction (Interline)    =      1.4                      	Low Minimum long length for a ledger
minSideRatio                     Ratio                =      0.9                      	Minimum ratio of filament length to be actually enlarged
minThicknessHigh              Fraction (Interline)    =      0.25                     	High Minimum thickness of an interesting stick
minWideLedgerLength           Fraction (Interline)    =      1.5                      	Minimum length for a wide ledger
printWatch                     Boolean                =      false                    	Should we print out the stop watch?

[org.audiveris.omr.sheet.ledger.LedgersFilter]
displayLedgers                 Boolean                =      false                    	Should we display the view on ledgers?
ledgerVipSections               String                =                               	(Debug) Comma-separated values of VIP ledger sections IDs
minDistanceFromStaff          Fraction (Interline)    =      0.5                      	Minimum vertical distance from nearest staff

[org.audiveris.omr.sheet.ledger.LedgersPostAnalysis]
maxDeltaSigmaCoeff              Double (none)         =      1.0                      	Coeff for standard deviation on maxDelta
maxHeightSigmaCoeff             Double (none)         =      1.0                      	Coeff for standard deviation on maxHeight
maxIsolatedLedgerWidth        Fraction (Interline)    =      3.0                      	Reasonable maximum width for an isolated ledger
minDeltaSigmaCoeff              Double (none)         =      -1.0                     	Coeff for standard deviation on minDelta
minHeightSigmaCoeff             Double (none)         =      -1.0                     	Coeff for standard deviation on minHeight

[org.audiveris.omr.sheet.note.DistancesBuilder]
displayTemplates               Boolean                =      false                    	Should we display the templates tab?

[org.audiveris.omr.sheet.note.HeadSeedTally]
dumpTally                      Boolean                =      false                    	Should we print out a dump of seed-head tally?
printResults                   Boolean                =      false                    	Should we print out the tally results?
quorum                         Integer (samples)      =      10                       	Minimum samples per head shape and horizontal side

[org.audiveris.omr.sheet.note.NoteHeadsBuilder]
allowAttachments               Boolean                =      false                    	Should we allow staff attachments for created areas?
barVerticalMargin             Fraction (Interline)    =      2.0                      	Vertical margin around frozen barline or connector
crossBoost                       Ratio                =      0.0                      	How much do we boost cross heads (badly recognized by template matching)
dumpTemplateNotes              Boolean                =      false                    	Should we dump the template notes for standard and drum staves?
gradeMargin                      Ratio                =      0.1                      	Grade margin to boost seed-based competitors
maxClosedDy                   Fraction (Interline)    =      0.0                      	Extension allowed in y when located on line/ledger
maxOpenDy                     Fraction (Interline)    =      0.2                      	Extension allowed in y when located in space
maxTemplateDx                 Fraction (Interline)    =      0.375                    	Maximum dx between similar template instances
minBeamWidth                  Fraction (Interline)    =      2.5                      	Minimum good beam width to exclude heads
minHoleWhiteRatio                Ratio                =      0.2                      	Minimum ratio of hole white pixel to reassign Black to Void
minIouHeads                      Ratio                =      0.1                      	Minimum intersection over union for head overlapping
pitchMargin                      Ratio                =      0.75                     	Vertical margin for intercepting stem seed around a target pitch
printParameters                Boolean                =      false                    	Should we print out the class parameters?
printWatch                     Boolean                =      false                    	Should we print out the stop watch?
stemLessBoost                    Ratio                =      0.0                      	How much do we boost stem-less heads (always isolated)

[org.audiveris.omr.sheet.rhythm.MeasuresBuilder]
minStandardWidth              Fraction (Interline)    =      4.0                      	Minimum measure width for not being a courtesy measure

[org.audiveris.omr.sheet.rhythm.SlotsRetriever]
dumpRelationships              Boolean                =      false                    	(debug) Dump matrix of chords relationships
maxAdjacencyXGap              Fraction (Interline)    =      0.4                      	Maximum horizontal gap between adjacent chords bounds
maxMergeDx                    Fraction (Interline)    =      1.0                      	Maximum horizontal delta between two slots for a merge
maxSlotDxHigh                 Fraction (Interline)    =      1.1                      	High maximum horizontal delta between a slot and a chord
maxSlotDxLow                  Fraction (Interline)    =      0.5                      	Low maximum horizontal delta between a slot and a chord
maxVerticalOverlap            Fraction (Interline)    =      0.25                     	Maximum vertical overlap tolerated

[org.audiveris.omr.sheet.stem.BeamLinker]
maxShorterRatio                  Ratio                =      0.8                      	Max ratio of base beam length to detect a shorter beam

[org.audiveris.omr.sheet.stem.HeadStemsCleaner]
yGapTiny                      Fraction (Interline)    =      0.2                      	Maximum vertical tiny gap between stem & head

[org.audiveris.omr.sheet.stem.StemBuilder]
displayHorizontalMargin       Fraction (Interline)    =      1.0                      	(debug) Horizontal margin around inter in a connection image
displayVerticalMargin         Fraction (Interline)    =      2.0                      	(debug) Vertical margin around inter in a connection image
displayZoom                      Ratio                =      20.0                     	(debug) Zoom applied on a connection image
saveConnections                Boolean                =      false                    	(debug) Should we save VIP stem connections to disk?

[org.audiveris.omr.sheet.stem.StemChecker]
beltMarginDx                  Fraction (Interline)    =      0.15                     	Horizontal belt margin checked around stem
blackHigh                     Fraction (Interline)    =      2.5                      	High minimum black length for a stem
blackHigh_p1                  Fraction (Interline)    =      1.25                     	Idem for profile 1
blackLow                      Fraction (Interline)    =      1.25                     	Low minimum black length for a stem
blackLow_p1                   Fraction (Interline)    =      0.625                    	Idem for profile 1
blackRatioLow                    Ratio                =      0.5                      	Low minimum ratio of black pixels for a stem
blackRatioLow_p1                 Ratio                =      0.3                      	Idem for profile 1
blackRatioLow_p2                 Ratio                =      0.2                      	Idem for profile 2
blackRatioLow_p3                 Ratio                =      0.1                      	Idem for profile 3
cleanHigh                     Fraction (Interline)    =      2.0                      	High minimum clean length for a stem
cleanLow                      Fraction (Interline)    =      0.5                      	Low minimum clean length for a stem
cleanLow_p1                   Fraction (Interline)    =      0.3                      	Idem for profile 1
cleanLow_p2                   Fraction (Interline)    =      0.2                      	Idem for profile 2
cleanLow_p3                   Fraction (Interline)    =      0.0                      	Idem for profile 3
gapHigh                       Fraction (Interline)    =      0.0                      	Maximum vertical gap between stem segments
gapHigh_p1                    Fraction (Interline)    =      0.3                      	Idem for profile 1
gapHigh_p2                    Fraction (Interline)    =      0.6                      	Idem for profile 2
gapHigh_p3                    Fraction (Interline)    =      2.0                      	Idem for profile 3
gapHigh_p4                    Fraction (Interline)    =      4.0                      	Idem for profile 4
goodCheckResult                  Grade (Grade)        =      0.5                      	Good result for suite of check
lengthHigh                    Fraction (Interline)    =      3.5                      	High minimum length for a stem
lengthLow                     Fraction (Interline)    =      1.25                     	Low minimum length for a stem
maxCoTangentForCheck            Double (cotangent)    =      0.1                      	Maximum cotangent for visual check
minCheckResult                   Grade (Grade)        =      0.2                      	Minimum result for suite of check
slopeHigh                       Double (tangent)      =      0.08                     	Maximum difference with global slope
straightHigh                  Fraction (Interline)    =      0.2                      	High maximum distance to average stem line

[org.audiveris.omr.sheet.stem.StemScaler]
minDerivativeRatio               Ratio                =      0.05                     	Absolute ratio of total pixels for strong derivative
minGainRatio                     Ratio                =      0.1                      	Minimum ratio of peak runs for stem peak extension
minValueRatio                    Ratio                =      0.1                      	Absolute ratio of total pixels for peak acceptance
printWatch                     Boolean                =      false                    	Should we print the StopWatch on stem computation?
saveStemImage                  Boolean                =      false                    	Should we save stem images on disk?
stemAsForeRatio                  Ratio                =      1.0                      	Default stem thickness defined as ratio of foreground peak
systemVerticalMargin          Fraction (Interline)    =      2.0                      	Margin erased above & below system header area
useHeader                      Boolean                =      true                     	Should we erase the header at system start

[org.audiveris.omr.sheet.stem.StemsRetriever]
artificialStemGrade              Ratio                =      0.4                      	Default grade for an artificial stem
halfBeamLuDx                  Fraction (Interline)    =      0.3                      	Half dx for beam lookup area for stem and heads
maxBarOverlap                    Ratio                =      0.25                     	Maximum stem overlap area ratio on a connected barline
maxBeamGroupDy                Fraction (Interline)    =      5.0                      	Maximum vertical gap between two beam groups on same stem
maxBeamLinkerDx               Fraction (Interline)    =      0.25                     	Maximum horizontal distance to reuse a beam linker
maxBeamSeedDx                 Fraction (Interline)    =      0.1                      	Maximum horizontal gap between beam and seed
maxBeamSeedDyRatio               Ratio                =      0.25                     	Maximum vertical gap between beam and seed as ratio of max gap with stem
maxBeamSideDx                 Fraction (Interline)    =      0.25                     	Maximum horizontal dx around beam sides to catch sibling groups
maxHeadSeedDy                 Fraction (Interline)    =      0.25                     	Maximum vertical gap between seed & head reference point
maxLineGlyphDx                Fraction (Interline)    =      0.2                      	Maximum distance from glyph centroid to current stem line
maxLineSectionDx              Fraction (Interline)    =      0.3                      	Maximum distance from section center to target line
maxLineSeedDx                 Fraction (Interline)    =      0.15                     	Maximum distance from stem seed to theoretical line
maxStemAlignmentDx            Fraction (Interline)    =      0.15                     	Maximum dx between aligned stem seeds
maxStemAlignmentDy            Fraction (Interline)    =      4.0                      	Maximum dy to check for aligned stem seeds
minBeamHeadDy                 Fraction (Interline)    =      1.0                      	Minimum vertical distance between beam and head
minBeamStemsDx                Fraction (Interline)    =      1.0                      	Minimum horizontal distance between two stems on the same beam
minBeamStumpDy                Fraction (Interline)    =      0.5                      	Minimum stump length above and below beam group
minHeadHeadDy                 Fraction (Interline)    =      0.25                     	Minimum vertical distance between two heads on a stem
minHeadStumpDy                Fraction (Interline)    =      0.5                      	Minimum stump length away from head corner reference
minLinkerLength               Fraction (Interline)    =      0.85                     	Minimum concrete length for a linker
minSeedContrib                Fraction (Interline)    =      0.5                      	Minimum seed vertical contribution to stem
printWatch                     Boolean                =      false                    	Should we print out the stop watch?
slopeMargin                     Double (tangent)      =      0.015                    	Margin around slope to define lookup areas
stumpAreaDxIn                 Fraction (Interline)    =      0.1                      	Inside half width of stump lookup area
stumpAreaDxOut                Fraction (Interline)    =      0.1                      	Outside half width of stump lookup area
stumpAreaDy                   Fraction (Interline)    =      0.2                      	Height of stump lookup area in head corner
vicinityMargin                Fraction (Interline)    =      1.0                      	Rough abscissa margin when looking for neighbors above and below in the system

[org.audiveris.omr.sheet.stem.VerticalsBuilder]
minCoreSectionLength          Fraction (Interline)    =      1.5                      	Minimum length for core sections
minSideRatio                     Ratio                =      0.4                      	Minimum ratio of filament length to be actually enlarged

[org.audiveris.omr.sheet.symbol.DotFactory]
minDyFromLine                 Fraction (Interline)    =      0.3                      	Minimum vertical distance between dot center and staff line/ledger

[org.audiveris.omr.sheet.symbol.LinksStep]
printWatch                     Boolean                =      false                    	Should we print out the stop watch?
removeFreeGlyphs               Boolean                =      false                    	Should we remove all free glyphs?

[org.audiveris.omr.sheet.symbol.SymbolsBuilder]
maxEvaluationCount             Integer (Evaluations)  =      2                        	Maximum number of evaluations kept for a symbol
maxGap                        Fraction (Interline)    =      0.6                      	Maximum distance between two compound parts
maxPartCount                   Integer (Glyphs)       =      7                        	Maximum number of parts considered for a symbol
maxSymbolHeight               Fraction (Interline)    =      10.0                     	Maximum height for a symbol (when found within staff abscissa range)
maxSymbolWidth                Fraction (Interline)    =      4.0                      	Maximum width for a symbol
minFineWeight             AreaFraction (Interline**2) =      0.006                    	Minimum weight for glyph consideration in a fine area
minWeight                 AreaFraction (Interline**2) =      0.03                     	Minimum weight for glyph consideration
printWatch                     Boolean                =      false                    	Should we print out the stop watch?
smallChordMargin              Fraction (Interline)    =      1.0                      	Margin on right side of small chords to extend fine boxes

[org.audiveris.omr.sheet.symbol.SymbolsFilter]
displaySymbols                 Boolean                =      false                    	Should we display the symbols image?
maxSymbolLength                Integer (letter count) =      3                        	Maximum number of chars for a word to be checked as a symbol
saveSymbolsBuffer              Boolean                =      false                    	Should we save symbols image on disk?
staffVerticalMargin           Fraction (Interline)    =      0.5                      	Margin erased above & below staff header area

[org.audiveris.omr.sheet.symbol.SymbolsStep]
printWatch                     Boolean                =      false                    	Should we print out the stop watch?

[org.audiveris.omr.sheet.time.TimeBuilder]
maxEvalRank                    Integer (none)         =      3                        	Maximum acceptable rank in time evaluation
maxFirstSpaceWidth            Fraction (Interline)    =      2.5                      	Maximum initial space before time signature
maxHalvesDx                   Fraction (Interline)    =      1.0                      	Maximum abscissa shift between top & bottom halves of a time signature
maxInnerSpace                 Fraction (Interline)    =      0.5                      	Maximum inner space within time signature
maxPartGap                    Fraction (Interline)    =      1.0                      	Maximum distance between two glyph parts of a single time symbol
maxSpaceCumul                 Fraction (Interline)    =      0.4                      	Maximum cumul value in space
maxTimeWidth                  Fraction (Interline)    =      2.0                      	Maximum width for a time signature
minHalfTimeWeight         AreaFraction (Interline**2) =      0.75                     	Minimum weight for a half time signature
minPartWeight             AreaFraction (Interline**2) =      0.01                     	Minimum weight for a glyph part
minTimeWidth                  Fraction (Interline)    =      1.0                      	Minimum width for a time signature
minWholeTimeWeight        AreaFraction (Interline**2) =      1.0                      	Minimum weight for a whole time signature
roiWidth                      Fraction (Interline)    =      4.0                      	Width of region of interest for time signature
yMargin                       Fraction (Interline)    =      0.1                      	Vertical white margin on raw rectangle

[org.audiveris.omr.sheet.time.TimeColumn]
maxDxOffset                   Fraction (Interline)    =      2.0                      	Maximum abscissa shift between deskewed time items in a column

[org.audiveris.omr.sheet.ui.BookActions]
closeConfirmation              Boolean                =      true                     	Should we ask confirmation for closing an unsaved book?
preOpenBookParameters          Boolean                =      false                    	Automatically open book parameters dialog at book creation?
swapProcessedSheets            Boolean                =      false                    	Automatically swap out sheets once they are processed?
validImageExtensions            String                =      .bmp .gif .jpg .jpeg .png .tiff .tif .pdf	Valid image file extensions, whitespace-separated

[org.audiveris.omr.sheet.ui.BookBrowser]
hideEmptyDummies               Boolean                =      false                    	Should we hide empty dummy containers
hideOriginatingInter           Boolean                =      true                     	Should we hide the originating inter when expanding a relation?

[org.audiveris.omr.sheet.ui.ObjectEditor]
handleArcRadius                 Double (pixels)       =      3.0                      	Arc radius at each corner of handle rounded rectangle
handleDetectionRadius           Double (pixels)       =      6.0                      	Detection radius around inter handle
handleHalfSide                  Double (pixels)       =      4.0                      	Half side of handle rounded rectangle
handleMaxZoom                    Ratio                =      2.0                      	Maximum effective zoom on handle

[org.audiveris.omr.sheet.ui.SelectionPainter]
minZoomForLinkNames              Ratio                =      2.0                      	Minimum zoom value to display link names

[org.audiveris.omr.sheet.ui.SheetEditor]
selectBasicClassifierBoard      Boolean                =      true                     	Should we select Basic Classifier board by default?
selectGlyphBoard               Boolean                =      false                    	Should we select Glyph board by default?
selectHorizontalSectionBoard      Boolean                =      false                    	Should we select Horizontal Section board by default?
selectInterBoard               Boolean                =      true                     	Should we select Inter board by default?
selectPixelBoard               Boolean                =      false                    	Should we select Pixel board by default?
selectShapeBoard               Boolean                =      true                     	Should we select Shape board by default?
selectVerticalSectionBoard      Boolean                =      false                    	Should we select Vertical Section board by default?

[org.audiveris.omr.sheet.ui.SheetPainter]
basicFontSize                  Integer (points)       =      30                       	Standard font size for annotations
chordIdZoom                      Ratio                =      0.5                      	Zoom applied on font for chords ID
chordVoiceAppended             Boolean                =      false                    	Should the chords voices be appended to ID?
drawPartLimits                 Boolean                =      false                    	Should we draw part upper and lower core limits
minDisplayZoomForChordId         Ratio                =      0.75                     	Minimum display zoom value to display chords ID
partDx                         Integer (pixels)       =      40                       	Abscissa right offset for part name
partDy                         Integer (pixels)       =      20                       	Ordinate down offset for part name
zoomForPartName                  Ratio                =      0.6                      	Zoom applied on part names

[org.audiveris.omr.sheet.ui.SheetResultPainter]
annotationDx                   Integer (pixels)       =      15                       	Abscissa offset for annotation near system
annotationDy                   Integer (pixels)       =      15                       	Ordinate offset for annotation near system
partDx                         Integer (pixels)       =      50                       	Abscissa left offset for logical part annotation
partDy                         Integer (pixels)       =      -20                      	Ordinate down offset for logical part annotation
zoomForLogicalPart               Ratio                =      0.6                      	Zoom applied on logical part names

[org.audiveris.omr.sheet.ui.SplitAndMerge]
lastFolder                      String                =                               	Latest folder used for playlist or compound

[org.audiveris.omr.sheet.ui.StaffEditor]
minWidthHeightRatio              Ratio                =      2.0                      	Minimum width/height ratio for a core section on a staff line

[org.audiveris.omr.sheet.ui.StubsController]
earlyStep                         Enum                =      BINARY                   	Early step triggered when an empty stub tab is selected 
initialZoomRatio                 Ratio                =      0.5                      	Initial zoom ratio for displayed sheet pictures

[org.audiveris.omr.sheet.ui.TemplateView]
minZoomRatio                     Ratio                =      4.0                      	Minimum zoom ratio to show template key points

[org.audiveris.omr.sig.CrossDetector]
minGradeDiff                     Grade (Grade)        =      0.1                      	Minimum difference in ctx-grade to be relevant

[org.audiveris.omr.sig.InterIndex]
vipInters                       String                =                               	(Debug) Comma-separated values of VIP inters IDs

[org.audiveris.omr.sig.SigReducer]
maxTupletSlurWidth            Fraction (Interline)    =      3.0                      	Maximum width for slur around tuplet
minIouStemHead                   Ratio                =      0.02                     	Minimum IOU between stem and intersected heads

[org.audiveris.omr.sig.inter.AbstractBeamInter]
minBeamWidth                  Fraction (Interline)    =      0.5                      	Minimum width for a beam or beam hook

[org.audiveris.omr.sig.inter.AbstractPitchedInter]
areaPitchOffset_FLAT            Double (pitch)        =      1.2                      	Pitch offset WRT area center for FLAT
areaPitchOffset_F_CLEF          Double (pitch)        =      -1.3                     	Pitch offset WRT area center for F_CLEF
areaPitchOffset_F_CLEF_8VA       Double (pitch)        =      0.0                      	Pitch offset WRT area center for F_CLEF_8VA
areaPitchOffset_F_CLEF_8VB       Double (pitch)        =      -2.5                     	Pitch offset WRT area center for F_CLEF_8VB
areaPitchOffset_F_CLEF_SMALL       Double (pitch)        =      -0.8                     	Pitch offset WRT area center for F_CLEF_SMALL
areaPitchOffset_G_CLEF          Double (pitch)        =      1.8                      	Pitch offset WRT area center for G_CLEF
areaPitchOffset_G_CLEF_8VA       Double (pitch)        =      2.9                      	Pitch offset WRT area center for G_CLEF_8VA
areaPitchOffset_G_CLEF_8VB       Double (pitch)        =      0.5                      	Pitch offset WRT area center for G_CLEF_8VB
areaPitchOffset_G_CLEF_SMALL       Double (pitch)        =      1.2                      	Pitch offset WRT area center for G_CLEF_SMALL

[org.audiveris.omr.sig.inter.AbstractTimeInter]
optionalTimes                   String                =      6/4, 7/8                 	Optional time sigs

[org.audiveris.omr.sig.inter.AlterInter]
flatMassPitchOffset             Double (pitch)        =      0.65                     	Pitch offset of flat WRT mass center
flatTypicalHeight             Fraction (Interline)    =      2.7                      	Typical flat height

[org.audiveris.omr.sig.inter.BeamGroupInter]
cueMaxSlopeDiff                 Double (tangent)      =      0.2                      	(Cue) Maximum slope difference between beams of a group
cueMaxYDistance               Fraction (Interline)    =      1.0                      	(Cue) Maximum vertical distance between subsequent beams of a group
cueMinXOverlap                Fraction (Interline)    =      0.7                      	(Cue) Minimum horizontal overlap between subsequent beams of a group
maxChordDy                    Fraction (Interline)    =      0.5                      	Maximum vertical gap between a chord and a beam
maxSlopeDiff                    Double (tangent)      =      0.065                    	Maximum slope difference between beams of a group
maxSplitLoops                  Integer (loops)        =      10                       	Maximum number of loops allowed for splitting beam groups
maxYDistance                  Fraction (Interline)    =      1.2                      	Maximum vertical distance between subsequent beams of a group
minXOverlap                   Fraction (Interline)    =      0.7                      	Minimum horizontal overlap between subsequent beams of a group

[org.audiveris.omr.sig.inter.BeamHookInter]
xMargin                       Fraction (Interline)    =      0.5                      	Width of lookup area for stem
xMargin_p1                    Fraction (Interline)    =      0.75                     	Idem for profile 1
yMargin                       Fraction (Interline)    =      0.5                      	Height of lookup area for stem
yMargin_p1                    Fraction (Interline)    =      0.75                     	Idem for profile 1

[org.audiveris.omr.sig.inter.DynamicsInter]
iosMinRatio                      Ratio                =      0.8                      	Minimum area ratio of intersection over shorter dynamics
maxDy                         Fraction (Interline)    =      7.0                      	Maximum vertical distance between dynamics center and related chord/staff
maxXGap                       Fraction (Interline)    =      1.0                      	Maximum horizontal gap between dynamics and related chord/staff

[org.audiveris.omr.sig.inter.EndingInter]
defaultThickness                Double (pixels)       =      2.0                      	Default ending lines thickness

[org.audiveris.omr.sig.inter.FermataInter]
maxFermataDy                  Fraction (Interline)    =      2.5                      	Maximum vertical distance between fermata center and related chord/staff/barline

[org.audiveris.omr.sig.inter.GraceChordInter]
sideDx                        Fraction (Interline)    =      1.5                      	Typical horizontal distance between grace head center & target center

[org.audiveris.omr.sig.inter.HeadInter]
maxOverlapAreaRatio              Ratio                =      0.25                     	Maximum acceptable box area overlap ratio between notes
maxOverlapDxRatio                Ratio                =      0.2                      	Maximum abscissa overlap ratio between notes to reject abscissa overlap
minOverlapDxRatio                Ratio                =      0.8                      	Minimum abscissa overlap ratio between notes to detect pitch overlap
shrinkHoriRatio                  Ratio                =      0.5                      	Horizontal shrink ratio to apply when checking note overlap
shrinkVertRatio                  Ratio                =      0.5                      	Vertical shrink ratio to apply when checking note overlap

[org.audiveris.omr.sig.inter.LedgerInter]
defaultLength                 Fraction (Interline)    =      2.0                      	Default ledger length (WRT interline)
defaultThickness                Double (Pixels)       =      3.0                      	Default ledger thickness

[org.audiveris.omr.sig.inter.LyricItemInter]
leftShift                     Fraction (Interline)    =      1.0                      	Shift of left item abscissa
maxItemDx                     Fraction (Interline)    =      3.0                      	Maximum horizontal distance between a note and its lyric item

[org.audiveris.omr.sig.inter.MeasureCountInter]
maxAbsolutePitch                Double (pitch)        =      10.0                     	Maximum absolute pitch value for a measure number

[org.audiveris.omr.sig.inter.NumberInter]
maxAbsolutePitch                Double (pitch)        =      10.0                     	Maximum absolute pitch value for a number
oneLineMaxTimeDy              Fraction (Interline)    =      0.25                     	Maximum vertical gap between a partial time and a 1-line staff

[org.audiveris.omr.sig.inter.OctaveShiftInter]
minGapFromStaff               Fraction (Interline)    =      2.0                      	Minimum vertical gap from upper or lower staff

[org.audiveris.omr.sig.inter.RestInter]
minInterChordDx               Fraction (Interline)    =      0.5                      	Minimum horizontal delta between two chords
suspiciousPitchPosition         Double (PitchPosition) =      2.0                      	Maximum absolute pitch position for a rest to avoid additional checks

[org.audiveris.omr.sig.inter.SlurInter]
maxDeltaY                     Fraction (Interline)    =      4.0                      	Maximum vertical difference in interlines between connecting slurs
maxPointingDy                   Double (pixels)       =      2.0                      	Maximum ordinate distance for pointing a slur
maxTieDeltaMeasureID           Integer (none)         =      1                        	Maximum delta in measure ID when setting a tie
maxTieIntersection               Ratio                =      0.25                     	Maximum intersection for a chord invading a tie

[org.audiveris.omr.sig.inter.StaffBarlineInter]
maxStaffBarlineShift          Fraction (Interline)    =      1.0                      	Maximum deskewed abscissa difference within a column

[org.audiveris.omr.sig.inter.StemInter]
anchorMarginRatio                Ratio                =      0.67                     	Anchor vertical margin, relative to head height
bestTailLength                Fraction (Interline)    =      2.5                      	Optimal stem tail length (after last head)
defaultThickness                Double (pixels)       =      3.0                      	Default stem width
minLengthForSlope             Fraction (Interline)    =      1.0                      	Minimum stem length for a reliable slope
minTailLength                 Fraction (Interline)    =      1.75                     	Minimum stem tail length (after last head)

[org.audiveris.omr.sig.inter.TimeNumberInter]
maxAbsolutePitch                Double (pitch)        =      3.0                      	Maximum absolute pitch value for a time signature number
minAbsolutePitch                Double (pitch)        =      1.0                      	Minimum absolute pitch value for a time signature number

[org.audiveris.omr.sig.inter.TremoloInter]
slope                           Double (tangent)      =      -0.31                    	Typical tremolo slope
width                         Fraction (Interline)    =      1.35                     	Typical tremolo width
widthMargin                   Fraction (Interline)    =      0.25                     	Margin around tremolo width

[org.audiveris.omr.sig.inter.TupletInter]
maxTupletChordDx              Fraction (Interline)    =      3.0                      	Maximum abscissa gap between tuplet and closest chord
maxTupletChordDy              Fraction (Interline)    =      2.5                      	Maximum ordinate gap between tuplet and closest chord

[org.audiveris.omr.sig.inter.WedgeInter]
defaultThickness                Double (pixels)       =      3.0                      	Default wedge line thickness
handleRatio                      Ratio                =      0.1                      	Ratio of handle below with respect to line length
stackAbscissaMargin           Fraction (Interline)    =      1.0                      	Margin beyond stack abscissa limits

[org.audiveris.omr.sig.relation.AbstractConnection]
xInWeight                        Ratio                =      1.0                      	Relative impact weight for xInGap
xOutWeight                       Ratio                =      2.0                      	Relative impact weight for xOutGap
yWeight                          Ratio                =      1.0                      	Relative impact weight for yGap

[org.audiveris.omr.sig.relation.AlterHeadRelation]
AccidentalCoeff                  Ratio                =      3.0                      	Supporting coeff for (source) accidental
xInGapMax                     Fraction (Interline)    =      0.2                      	Maximum horizontal overlap between accid & note head
xInGapMax_p1                  Fraction (Interline)    =      0.3                      	Idem for profile 1
xInWeight                        Ratio                =      1.0                      	Relative impact weight for xInGap
xOutGapMax                    Fraction (Interline)    =      2.0                      	Maximum horizontal gap between accid & note head
xOutGapMax_p1                 Fraction (Interline)    =      3.0                      	Idem for profile 1
xOutWeight                       Ratio                =      1.0                      	Relative impact weight for xOutGap
yGapMax                       Fraction (Interline)    =      0.45                     	Maximum vertical gap between accid & note head
yGapMax_p1                    Fraction (Interline)    =      0.6                      	Idem for profile 1
yWeight                          Ratio                =      4.0                      	Relative impact weight for yGap

[org.audiveris.omr.sig.relation.AugmentationRelation]
dotSupportCoeff                  Ratio                =      3.0                      	Supporting coeff for (source) dot
xOutGapMax                    Fraction (Interline)    =      2.0                      	Maximum horizontal gap between dot center & note/rest reference point
xOutGapMax_p1                 Fraction (Interline)    =      2.0                      	Idem for profile 1
xOutGapMin                    Fraction (Interline)    =      0.25                     	Minimum horizontal gap between dot center & note/rest reference point
xOutGapMin_p1                 Fraction (Interline)    =      0.1                      	Idem for profile 1
xOutWeight                       Ratio                =      0.0                      	Relative impact weight for xOutGap
yGapMax                       Fraction (Interline)    =      0.8                      	Maximum vertical gap between dot center & note/rest reference point
yGapMax_p1                    Fraction (Interline)    =      1.2                      	Idem for profile 1
yWeight                          Ratio                =      1.0                      	Relative impact weight for yGap

[org.audiveris.omr.sig.relation.BarConnectionRelation]
barSupportCoeff                  Ratio                =      5.0                      	Value for source/target (bar) coeff in support formula

[org.audiveris.omr.sig.relation.BeamBeamRelation]
beamSupportCoeff                 Ratio                =      3.0                      	Value for (source or target) beam coeff in beam-beam support formula

[org.audiveris.omr.sig.relation.BeamHeadRelation]
headSideSupportCoeff             Ratio                =      1.0                      	Supporting coeff for side (target) head
headSupportCoeff                 Ratio                =      0.75                     	Supporting coeff for (target) head

[org.audiveris.omr.sig.relation.BeamRestRelation]
xInGapMax                     Fraction (Interline)    =      1.0                      	Maximum horizontal overlap between rest & beam

[org.audiveris.omr.sig.relation.BeamStemRelation]
beamSupportCoeff                 Ratio                =      4.0                      	Value for source (beam) coeff in support formula
sideStemSupportCoeff             Ratio                =      10.0                     	Value for target (stem on beam side) coeff in support formula
stemSupportCoeff                 Ratio                =      3.0                      	Value for target (stem) coeff in support formula
xInGapMax                     Fraction (Interline)    =      0.5                      	Maximum horizontal overlap between stem & beam
xInGapMax_p1                  Fraction (Interline)    =      0.75                     	Idem for profile 1
xOutGapMax                    Fraction (Interline)    =      0.15                     	Maximum horizontal gap between stem & beam
xOutGapMax_p1                 Fraction (Interline)    =      0.2                      	Idem for profile 1
xOutWeight                       Ratio                =      1.0                      	Relative impact weight for xOutGap
yGapMax                       Fraction (Interline)    =      0.8                      	Maximum vertical gap between stem & beam
yGapMax_p1                    Fraction (Interline)    =      1.2                      	Idem for profile 1
yGapMax_p2                    Fraction (Interline)    =      2.0                      	Idem for profile 2
yGapMax_p3                    Fraction (Interline)    =      4.0                      	Idem for profile 3
yWeight                          Ratio                =      4.0                      	Relative impact weight for yGap

[org.audiveris.omr.sig.relation.ChordArpeggiatoRelation]
arpeggiatoSupportCoeff           Ratio                =      0.5                      	Supporting coeff for (source) arpeggiato
xGapMax                       Fraction (Interline)    =      1.5                      	Maximum horizontal gap between arpeggiato & chord
xGapMax_p1                    Fraction (Interline)    =      2.5                      	Idem for profile 1

[org.audiveris.omr.sig.relation.ChordArticulationRelation]
articulationSupportCoeff         Ratio                =      3.0                      	Supporting coeff for (target) articulation
xGapMax                       Fraction (Interline)    =      0.8                      	Maximum horizontal gap between articulation center & chord
xGapMax_p1                    Fraction (Interline)    =      1.0                      	Idem for profile 1
xWeight                          Ratio                =      3.0                      	Relative impact weight for xGap (in or out)
yGapMax                       Fraction (Interline)    =      2.0                      	Maximum vertical gap between articulation center & chord
yGapMax_p1                    Fraction (Interline)    =      3.0                      	Idem for profile 1
yGapMin                       Fraction (Interline)    =      0.1                      	Minimum vertical gap between articulation center & chord
yGapMin_p1                    Fraction (Interline)    =      0.05                     	Idem for profile 1
yWeight                          Ratio                =      1.0                      	Relative impact weight for yGap

[org.audiveris.omr.sig.relation.ChordGraceRelation]
graceCoeff                       Ratio                =      0.5                      	Supporting coeff for (target) grace
xGapMax                       Fraction (Interline)    =      2.5                      	Maximum horizontal distance between grace & head centers
yGapMax                       Fraction (Interline)    =      1.5                      	Maximum vertical distance between grace & head centers

[org.audiveris.omr.sig.relation.ChordOrnamentRelation]
ornamentTargetCoeff              Ratio                =      0.5                      	Supporting coeff for (target) ornament
xGapMax                       Fraction (Interline)    =      0.75                     	Maximum horizontal gap between ornament center & chord
xGapMax_p1                    Fraction (Interline)    =      1.2                      	Idem for profile 1
yGapMax                       Fraction (Interline)    =      2.0                      	Maximum vertical gap between ornament center & chord
yGapMax_p1                    Fraction (Interline)    =      3.0                      	Idem for profile 1

[org.audiveris.omr.sig.relation.ChordSentenceRelation]
xGapMax                       Fraction (Interline)    =      1.0                      	Maximum horizontal gap between chord & sentence

[org.audiveris.omr.sig.relation.ChordTupletRelation]
tupletSixSupportCoeff            Ratio                =      0.34                     	Supporting coeff for tuplet 6
tupletThreeSupportCoeff          Ratio                =      0.66                     	Supporting coeff for tuplet 3

[org.audiveris.omr.sig.relation.ClefKeyRelation]
clefSupportCoeff                 Ratio                =      5.0                      	Value for (source) clef coeff in support formula
keySupportCoeff                  Ratio                =      5.0                      	Value for (target) key coeff in support formula

[org.audiveris.omr.sig.relation.DotFermataRelation]
arcSupportCoeff                  Ratio                =      5.0                      	Supporting coeff for (target) fermata
dotSupportCoeff                  Ratio                =      5.0                      	Supporting coeff for (source) dot
xOutGapMax                    Fraction (Interline)    =      0.75                     	Maximum horizontal gap between dot center & fermata reference point
xOutGapMax_p1                 Fraction (Interline)    =      1.0                      	Idem for profile 1
xOutWeight                       Ratio                =      1.0                      	Relative impact weight for xOutGap
yGapMax                       Fraction (Interline)    =      0.5                      	Maximum vertical gap between dot center & fermata reference point
yGapMax_p1                    Fraction (Interline)    =      0.75                     	Idem for profile 1
yWeight                          Ratio                =      1.0                      	Relative impact weight for yGap

[org.audiveris.omr.sig.relation.DoubleDotRelation]
secondDotSupportCoeff            Ratio                =      5.0                      	Supporting coeff for (source) second dot
xOutGapMax                    Fraction (Interline)    =      1.25                     	Maximum horizontal gap between dots centers
xOutGapMax_p1                 Fraction (Interline)    =      2.0                      	Idem for profile 1
xOutGapMin                    Fraction (Interline)    =      0.2                      	Minimum horizontal gap between dot centers
xOutGapMin_p1                 Fraction (Interline)    =      0.1                      	Idem for profile 1
xOutWeight                       Ratio                =      1.0                      	Relative impact weight for xOutGap
yGapMax                       Fraction (Interline)    =      0.25                     	Maximum vertical gap between dots centers
yGapMax_p1                    Fraction (Interline)    =      0.4                      	Idem for profile 1
yWeight                          Ratio                =      3.0                      	Relative impact weight for yGap

[org.audiveris.omr.sig.relation.EndingBarRelation]
endingSupportCoeff               Ratio                =      3.0                      	Supporting coeff for (source) ending
xGapMax                       Fraction (Interline)    =      2.0                      	Maximum horizontal gap between ending and barline
xGapMax_p1                    Fraction (Interline)    =      3.0                      	Idem for profile 1
xWeight                          Ratio                =      1.0                      	Relative impact weight for xGap (in or out)
yGapMax                       Fraction (Interline)    =      10.0                     	Maximum vertical gap between bottom of ending leg and top of barline
yGapMax_p1                    Fraction (Interline)    =      15.0                     	Idem for profile 1
yWeight                          Ratio                =      0.0                      	Relative impact weight for yGap

[org.audiveris.omr.sig.relation.FermataBarRelation]
fermataSupportCoeff              Ratio                =      5.0                      	Supporting coeff for (source) fermata

[org.audiveris.omr.sig.relation.FermataChordRelation]
chordSupportCoeff                Ratio                =      2.0                      	Supporting coeff for (target) chord
fermataSupportCoeff              Ratio                =      5.0                      	Supporting coeff for (source) fermata

[org.audiveris.omr.sig.relation.FlagStemRelation]
flagSupportCoeff                 Ratio                =      3.0                      	Value for source (flag) coeff in support formula
stemSupportCoeff                 Ratio                =      3.0                      	Value for target (stem) coeff in support formula
xInGapMax                     Fraction (Interline)    =      0.3                      	Maximum horizontal overlap between stem & flag
xInGapMax_p1                  Fraction (Interline)    =      0.45                     	Idem for profile 1
xOutGapMax                    Fraction (Interline)    =      0.3                      	Maximum horizontal gap between stem & flag
xOutGapMax_p1                 Fraction (Interline)    =      0.45                     	Idem for profile 1
yGapMax                       Fraction (Interline)    =      0.5                      	Maximum vertical gap between stem & flag
yGapMax_p1                    Fraction (Interline)    =      0.75                     	Idem for profile 1

[org.audiveris.omr.sig.relation.HeadFingeringRelation]
fingeringTargetCoeff             Ratio                =      2.0                      	Supporting coeff for (target) fingering
xGapMax                       Fraction (Interline)    =      1.5                      	Maximum horizontal gap between fingering center & chord
xGapMax_p1                    Fraction (Interline)    =      2.5                      	Idem for profile 1
yGapMax                       Fraction (Interline)    =      2.0                      	Maximum vertical gap between fingering center & chord
yGapMax_p1                    Fraction (Interline)    =      3.0                      	Idem for profile 1

[org.audiveris.omr.sig.relation.HeadHeadRelation]
headSupportCoeff                 Ratio                =      0.75                     	Value for (source or target) head coeff in head-head support formula

[org.audiveris.omr.sig.relation.HeadPlayingRelation]
playingTargetCoeff               Ratio                =      0.5                      	Supporting coeff for (target) playing
xGapMax                       Fraction (Interline)    =      0.25                     	Maximum horizontal gap between playing center & chord
xGapMax_p1                    Fraction (Interline)    =      1.2                      	Idem for profile 1
yGapMax                       Fraction (Interline)    =      2.0                      	Maximum vertical gap between playing center & chord
yGapMax_p1                    Fraction (Interline)    =      3.0                      	Idem for profile 1

[org.audiveris.omr.sig.relation.HeadPluckingRelation]
pluckingTargetCoeff              Ratio                =      2.0                      	Supporting coeff for (target) plucking
xGapMax                       Fraction (Interline)    =      1.5                      	Maximum horizontal gap between plucking center & chord
xGapMax_p1                    Fraction (Interline)    =      2.5                      	Idem for profile 1
yGapMax                       Fraction (Interline)    =      2.0                      	Maximum vertical gap between plucking center & chord
yGapMax_p1                    Fraction (Interline)    =      3.0                      	Idem for profile 1

[org.audiveris.omr.sig.relation.HeadStemRelation]
anchorHeightRatio                Ratio                =      0.275                    	Vertical margin for stem anchor portion (as ratio of head height)
headSupportCoeff                 Ratio                =      4.0                      	Value for (source) head coeff in support formula
maxInvadingDx                 Fraction (Interline)    =      0.05                     	Maximum invading horizontal gap between stem & head
maxInvadingDy                 Fraction (Interline)    =      0.0                      	Maximum invading vertical gap between stem & head
neutralStemLength             Fraction (Interline)    =      2.8                      	Neutral stem length between small and standard
stemSupportCoeff                 Ratio                =      10.0                     	Value for (target) stem coeff in support formula
xInGapMax                     Fraction (Interline)    =      0.2                      	Maximum horizontal overlap between stem & head
xInGapMax_p1                  Fraction (Interline)    =      0.4                      	Idem for profile 1
xOutGapMax                    Fraction (Interline)    =      0.15                     	Maximum horizontal gap between stem & head
xOutGapMax_p1                 Fraction (Interline)    =      0.25                     	Idem for profile 1
yGapMax                       Fraction (Interline)    =      0.8                      	Maximum vertical gap between stem & head
yGapMax_p1                    Fraction (Interline)    =      1.2                      	Idem for profile 1

[org.audiveris.omr.sig.relation.KeyAltersRelation]
sourceSupportCoeff               Ratio                =      5.0                      	Value for (source) alter coeff in support formula
targetSupportCoeff               Ratio                =      5.0                      	Value for (target) alter coeff in support formula

[org.audiveris.omr.sig.relation.MarkerBarRelation]
markerSupportCoeff               Ratio                =      3.0                      	Supporting coeff for (source) marker

[org.audiveris.omr.sig.relation.RepeatDotBarRelation]
repeatDotSupportCoeff            Ratio                =      5.0                      	Supporting coeff for (source) repeat dot
xOutGapMax                    Fraction (Interline)    =      1.5                      	Maximum horizontal gap between dot center & barline reference point
xOutGapMax_p1                 Fraction (Interline)    =      2.2                      	Idem for profile 1
xOutWeight                       Ratio                =      3.0                      	Relative impact weight for xOutGap
yGapMax                       Fraction (Interline)    =      0.5                      	Maximum vertical gap between dot center & barline reference point
yGapMax_p1                    Fraction (Interline)    =      0.75                     	Idem for profile 1
yWeight                          Ratio                =      1.0                      	Relative impact weight for yGap

[org.audiveris.omr.sig.relation.RepeatDotPairRelation]
dotSupportCoeff                  Ratio                =      5.0                      	Value for source/target (dot) coeff in support formula

[org.audiveris.omr.sig.relation.SlurHeadRelation]
slurSupportCoeff                 Ratio                =      5.0                      	Value for (source) slur coeff in support formula

[org.audiveris.omr.sig.relation.Support]
minGrade                         Ratio                =      0.1                      	Minimum support relation grade

[org.audiveris.omr.sig.relation.TimeTopBottomRelation]
numberSupportCoeff               Ratio                =      5.0                      	Value for (source/target) number coeff in support formula

[org.audiveris.omr.sig.relation.TremoloStemRelation]
xOutGapMax                    Fraction (Interline)    =      0.3                      	Maximum horizontal distance between stem & tremolo center
yGapMax                       Fraction (Interline)    =      0.0                      	Maximum vertical gap between stem & tremolo

[org.audiveris.omr.sig.relation.TremoloWholeRelation]
xOutGapMax                    Fraction (Interline)    =      0.3                      	Maximum horizontal distance between whole head center & tremolo center
yGapMax                       Fraction (Interline)    =      2.0                      	Maximum vertical gap between whole head & tremolo

[org.audiveris.omr.sig.ui.ChordListMenu]
maxAbscissaGapForTimeItems     Fraction (Interline)    =      2.0                      	Maximum abscissa gap between chords bounds for a time menu item
maxAbscissaOverlapForVoiceItems     Fraction (Interline)    =      0.2                      	Maximum abscissa overlap between chords bounds for a voice menu item
maxChordDxForMerge            Fraction (Interline)    =      2.0                      	Maximum abscissa shift between chords centers for a merge
maxStemDxForMerge             Fraction (Interline)    =      0.3                      	Maximum abscissa shift between chords stems for a merge

[org.audiveris.omr.sig.ui.InterBoard]
fontForAlterations              String                =      Lucida Sans Unicode      	Name of font able to display alteration signs
shapeIconHeight             PixelCount (Pixels)       =      70                       	Exact pixel height for the shape icon field
shapeIconWidth              PixelCount (Pixels)       =      50                       	Exact pixel width for the shape icon field

[org.audiveris.omr.sig.ui.InterController]
gutterRatio                      Ratio                =      0.33                     	Vertical margin as ratio of inter-staff gutter
useStaffLink                   Boolean                =      true                     	Should we use link for staff selection
useStaffProximity              Boolean                =      true                     	Should we use proximity for staff selection

[org.audiveris.omr.sig.ui.ShapeBoard]
maxHistoryLength               Integer (shapes)       =      8                        	Maximum number of shapes kept in history

[org.audiveris.omr.step.BinaryStep]
printWatch                     Boolean                =      false                    	Should we print out the stop watch?

[org.audiveris.omr.step.LoadStep]
maxPixelCount                  Integer (Pixels)       =      20000000                 	Maximum image size, specified in pixel count (0 for no check)

[org.audiveris.omr.step.ReductionStep]
refineStemHeadEnd              Boolean                =      true                     	Should we refine every stem head end at terminating head anchor?
refineStemTailEnd              Boolean                =      true                     	Should we refine every stem tail end at last beam?

[org.audiveris.omr.step.ui.StepMonitor]
divisions                      Integer (divisions)    =      1000                     	Number of divisions (amount of precision) of step monitor, minimum 10
ratio                            Ratio                =      0.1                      	Amount by which to increase step monitor percentage per animation, between 0 and 1
useIndeterminate               Boolean                =      true                     	Should we use an indeterminate step progress bar?

[org.audiveris.omr.text.Language]
defaultSpecification            String                =      deu+eng+fra              	OCR language(s)

[org.audiveris.omr.text.OcrUtil]
dumpWords                      Boolean                =      false                    	Should we dump words when we dump lines?
whiteMarginAdded               Integer (pixels)       =      10                       	Margin of white pixels added around image to OCR

[org.audiveris.omr.text.SheetScanner]
displayTexts                   Boolean                =      false                    	Should we display the texts image?
printWatch                     Boolean                =      false                    	Should we print out the stop watch?
saveTextsBuffer                Boolean                =      false                    	Should we save texts buffer on disk?
staffHorizontalMargin         Fraction (Interline)    =      0.25                     	Horizontal margin around staff core area
staffVerticalMargin           Fraction (Interline)    =      0.25                     	Vertical margin around staff core area

[org.audiveris.omr.text.TextBuilder]
maxLineDy                     Fraction (Interline)    =      1.0                      	Max vertical gap between two line chunks
printWatch                     Boolean                =      false                    	Should we print out the stop watch?

[org.audiveris.omr.text.TextLine]
maxCharDx                     Fraction (Interline)    =      1.0                      	Max horizontal gap between two chars in a word
maxChordDx                    Fraction (Interline)    =      1.0                      	Max horizontal gap between two chord words
maxFontSize                   Fraction (Interline)    =      5.0                      	Maximum font size with respect to interline
maxSentenceGrade                 Ratio                =      0.9                      	Maximum value for final sentence grade
maxTitleFontSize              Fraction (Interline)    =      8.0                      	Maximum font size for titles with respect to interline
maxWordDxFontRatio               Ratio                =      1.5                      	Max horizontal gap between two non-lyrics words as font ratio
minFontSize                   Fraction (Interline)    =      1.25                     	Minimum font size with respect to interline
minWordDxFontRatio               Ratio                =      0.125                    	Min horizontal gap between two non-lyrics words as font ratio
sentenceLowerLength            Integer (Chars)        =      10                       	Minimum number of characters to boost a sentence grade
sentenceUpperLength            Integer (Chars)        =      50                       	Maximum number of characters to boost a sentence grade

[org.audiveris.omr.text.TextRole]
maxCenterDx                   Fraction (Interline)    =      30.0                     	Maximum horizontal distance around center of page
maxRightDx                    Fraction (Interline)    =      2.0                      	Maximum horizontal distance on the right end of the staff
maxShortLength                Fraction (Interline)    =      35.0                     	Maximum length for a short sentence (no lyrics)
maxStaffDy                    Fraction (Interline)    =      7.0                      	Maximum distance above staff for a direction (or lyrics above staves)
maxTinyLength                 Fraction (Interline)    =      2.5                      	Maximum length for a tiny sentence (no lyrics)
minStaffDy                    Fraction (Interline)    =      6.0                      	Minimum distance below staff for a copyright
minTitleHeight                Fraction (Interline)    =      3.0                      	Minimum height for a title text

[org.audiveris.omr.text.TextWord]
abnormalWordRegexp              String                =      ^[^a-zA-Z_0-9-.,&=\?]+$ 	Regular expression to detect abnormal words
dashedWordRegexp                String                =      ^.*[-_].*$              	Regular expression to detect words with embedded dashes
longDashWordRegexp              String                =      ^[-_]{2,}$              	Regular expression to detect long (2+) dash-only words
lowConfidence                   Double (0..1)         =      0.3                      	Really low confidence to exclude words
maxFontRatio                     Ratio                =      2.0                      	Maximum ratio between ocr and glyph font sizes
minFontRatio                     Ratio                =      0.5                      	Minimum ratio between ocr and glyph font sizes
oneLetterWordRegexp             String                =      ^[\W]*([\w])[\W]*$       	Regular expression to detect one-letter words
partNameRegexp                  String                =      .*[\w]+.*$               	Regular expression to validate a part name
standardFontSize              Fraction (Interline)    =      2.5                      	Standard font size
tupletWordRegexp                String                =      ^.*[-_][36][-_].*$     	Regular expression to detect tuplet-like words

[org.audiveris.omr.text.tesseract.TesseractOCR]
forceSingleBlock               Boolean                =      false                    	Should we force OCR to use PSM_SINGLE_BLOCK rather than PSM_AUTO?
minConfidence                   Double (0..1)         =      0.65                     	Minimum confidence for OCR validity
saveImages                     Boolean                =      false                    	Should we save on disk the images sent to Tesseract?
useOCR                         Boolean                =      true                     	Should we use the OCR feature?

[org.audiveris.omr.text.tesseract.TesseractOrder]
blackList                       String                =                               	Character black list (disabled when empty)
typicalImageResolution         Integer (dpi)          =      70                       	Typical image resolution in DPI (disabled when set to -1)
whiteList                       String                =                               	Character white list (disabled when empty)

[org.audiveris.omr.ui.AboutAction]
titleFontSize                  Integer (Points)       =      14                       	Font size for title in about box
urlFontSize                    Integer (Points)       =      10                       	Font size for URL in about box

[org.audiveris.omr.ui.GuiActions]
manualUrl                       String                =      https://audiveris.github.io/audiveris/	URL of Audiveris manual
webSiteUrl                      String                =      http://www.audiveris.org 	URL of Audiveris home page
wikiUrl                         String                =      https://github.com/Audiveris/audiveris/wiki	URL of Audiveris wiki

[org.audiveris.omr.ui.MainGui]
preloadCostlyPackages          Boolean                =      true                     	Should we preload costly packages in the background?

[org.audiveris.omr.ui.MemoryMeter]
alarmThreshold                   Ratio                =      0.75                     	Memory alarm threshold, expressed in ratio of total memory
samplingPeriod                 Integer (MilliSeconds) =      2000                     	Memory display period

[org.audiveris.omr.ui.ViewParameters]
annotationPainting             Boolean                =      true                     	Should the annotations be painted
attachmentPainting             Boolean                =      false                    	Should the staff & glyph attachments be painted
invalidSheetDisplay            Boolean                =      true                     	Should the invalid sheets be displayed
letterBoxPainting              Boolean                =      true                     	Should the letter boxes be painted
linePainting                   Boolean                =      false                    	Should the stick lines be painted
markPainting                   Boolean                =      true                     	Should the marks be painted
sentencePainting               Boolean                =      true                     	Should the sentence words links be painted
slotPainting                   Boolean                =      true                     	Should the slots be painted
translationPainting            Boolean                =      true                     	Should the glyph translations links be painted
translucentPainting            Boolean                =      true                     	Should the inters be painted with grade-based translucency

[org.audiveris.omr.ui.action.AdvancedTopics]
useAnnotations                 Boolean                =      false                    	Production of image annotation with symbols
useDebug                       Boolean                =      false                    	Support for debug features
usePlots                       Boolean                =      false                    	Display of scale / stem / staves plots
useSamples                     Boolean                =      false                    	Handling of samples repositories and classifier
useSpecificItems               Boolean                =      false                    	Specific items shown in sheet view
useSpecificViews               Boolean                =      false                    	Display of specific sheet views

[org.audiveris.omr.ui.selection.SelectionService]
checkPublishedEvents           Boolean                =      true                     	(debug) Should we check published events?

[org.audiveris.omr.ui.symbol.MusicFont]
defaultMusicFamily                Enum                =      Bravura                  	Default font family for music symbols
headRatio                        Ratio                =      1.0                      	Ratio applied on font size for better head rendering

[org.audiveris.omr.ui.symbol.OctaveShiftSymbol]
defaultHookLength             Fraction (Interline)    =      1.0                      	Default length for ending hook
defaultLineLength             Fraction (Interline)    =      3.0                      	Default length for octave shift line
defaultThickness                Double (pixels)       =      2.0                      	Default ottava line thickness

[org.audiveris.omr.ui.symbol.OmrFont]
smallRatio                       Ratio                =      0.67                     	Ratio applied to small shapes (cue/grace head or clef change)
tinyRatio                        Ratio                =      0.5                      	Ratio applied to tiny symbols (generally for buttons)

[org.audiveris.omr.ui.symbol.TextFont]
defaultTextFamily                 Enum                =      SansSerif                	Default font family for text
defaultTextFontName             String                =      Sans Serif               	Default font name for texts
defaultTextFontSize            Integer (points)       =      10                       	Default font point size for texts
maxFontResizeRatio               Ratio                =      1.3                      	Maximum font increase ratio when recomputed

[org.audiveris.omr.ui.util.BasicAttachmentHolder]
keyFontRatio                     Ratio                =      1.0                      	Ratio of standard font size for the attachment key
keyPainting                    Boolean                =      true                     	Should the attachment key be painted?
minZoomForKey                    Ratio                =      2.0                      	Minimum zoom value to display the attachment key

[org.audiveris.omr.ui.util.CursorController]
delay                          Integer (ms)           =      500                      	Default delay value in milli-seconds

[org.audiveris.omr.ui.util.FixedWidthIcon]
iconWidth                      Integer (pixels)       =      30                       	Fixed icon width

[org.audiveris.omr.ui.util.Panel]
buttonWidth                     String                =      45dlu                    	Width of a standard button
fieldInterline                  String                =      1dlu                     	Vertical gap between two lines
fieldInterval                   String                =      3dlu                     	Horizontal gap between two fields
fieldWidth                      String                =      35dlu                    	Width of a field value
insetBottom                 PixelCount (Pixels)       =      6                        	Value of Bottom inset
insetLeft                   PixelCount (Pixels)       =      6                        	Value of Left inset
insetRight                  PixelCount (Pixels)       =      6                        	Value of Right inset
insetTop                    PixelCount (Pixels)       =      6                        	Value of Top inset
labelInterval                   String                =      1dlu                     	Horizontal gap between a field label and its field value
labelWidth                      String                =      25dlu                    	Width of the label of a field
panelInterline                  String                =      6dlu                     	Vertical gap between two panels

[org.audiveris.omr.ui.util.SeparableToolBar]
separatorWidth                 Integer (Pixels)       =      15                       	Width of separator

[org.audiveris.omr.ui.util.UILookAndFeel]
lookAndFeel                     String                =      com.jgoodies.looks.plastic.Plastic3DLookAndFeel	Full class path to the desired UI Look & Feel

[org.audiveris.omr.ui.util.UIUtil]
defaultFontName                 String                =      Arial                    	Default font name (e.g. Arial, Dialog, Segoe UI, ...
defaultFontSize                Integer (Points)       =      12                       	Default font size
globalFontRatio                  Ratio                =      1.0                      	Ratio to be applied on every font size (restart needed)
maxGlobalFontRatio               Ratio                =      2.0                      	Maximum value for global font ratio
minGlobalFontRatio               Ratio                =      1.0                      	Minimum value for global font ratio
urlFontSize                    Integer (Points)       =      9                        	Font size for URL

[org.audiveris.omr.ui.view.LogSlider]
resolution                     Integer (Values)       =      480                      	Number of values between two major ticks

[org.audiveris.omr.ui.view.Rubber]
crossLegLength                 Integer (Pixels)       =      100                      	Length for each leg of the rubber cross
showCross                      Boolean                =      true                     	Should we show just a cross for rubber (or whole lines)

[org.audiveris.omr.ui.view.RubberPanel]
focusMargin                 PixelCount (Pixels)       =      20                       	Margin visible around a focus

[org.audiveris.omr.ui.view.ScrollView]
unitIncrement                  Integer (Pixels)       =      20                       	Size of mouse wheel increment for ScrollView

[org.audiveris.omr.ui.view.Zoom]
continuousSliderReading        Boolean                =      true                     	Should we allow continuous reading of the zoom slider

[org.audiveris.omr.util.BrokenLine]
colinearDistance               Integer (Pixels)       =      2                        	Maximum distance from a point to a segment to be colinear
draggingDistance               Integer (Pixels)       =      25                       	Maximum distance from a point to drag it
stickyDistance                 Integer (Pixels)       =      5                        	Maximum distance from a point or segment to get stuck to it

[org.audiveris.omr.util.Dumper]
fontName                        String                =      Lucida Console           	Font name for HTML dump
fontSize                       Integer (Points)       =      9                        	Font size for HTML dump

[org.audiveris.omr.util.OmrExecutors]
graceDelay                     Integer (seconds)      =      60                       	Time to wait for terminating tasks
printEnvironment               Boolean                =      false                    	Should we print out current environment?
useParallelism                 Boolean                =      false                    	Should we use parallelism when we have several processors?
